AAAAAAGTACC -> AAAAAGTACCA
AAAAACAAGTG -> AAAACAAGTGC
AAAAAGTACCA -> AAAAGTACCAT
AAAACAAGTGC -> AAACAAGTGCT
AAAACGCGCAA -> AAACGCGCAAC
AAAAGTACCAT -> AAAGTACCATT
AAACAAGTGCT -> AACAAGTGCTG
AAACCAAGCAG -> AACCAAGCAGT
AAACCCTATTT -> AACCCTATTTC
AAACGCGCAAC -> AACGCGCAACC
AAACTCCATGT -> AACTCCATGTT
AAACTGGACGC -> AACTGGACGCA
AAACTTAATTA -> AACTTAATTAG
AAAGTACCATT -> AAGTACCATTT
AAAGTGCCCGA -> AAGTGCCCGAA
AAAGTGCGACA -> AAGTGCGACAT
AAATACGCAGA -> AATACGCAGAC
AAATATAATTT -> AATATAATTTA
AAATCTATAAT -> AATCTATAATA
AACAAGGTTAG -> ACAAGGTTAGG
AACAAGTGCTG -> ACAAGTGCTGC
AACAATATCTG -> ACAATATCTGC
AACATGATTGG -> ACATGATTGGA
AACATGCTAAG -> ACATGCTAAGC
AACATGGACAA -> ACATGGACAAG
AACCAAGCAGT -> ACCAAGCAGTC
AACCCGAGTTC -> ACCCGAGTTCC
AACCCTATTTC -> ACCCTATTTCG
AACCCTTAGAG -> ACCCTTAGAGT
AACCGTATAGG -> ACCGTATAGGT
AACCGTCTGTA -> ACCGTCTGTAA
AACGCGCAACC -> ACGCGCAACCC
AACGCTGCCAT -> ACGCTGCCATT
AACGGAGACAT -> ACGGAGACATC
AACGTCTAACG -> ACGTCTAACGC
AACTCCATGTT -> ACTCCATGTTT
AACTCTTATAC -> ACTCTTATACT
AACTGCGCGGG -> ACTGCGCGGGC
AACTGCTAGGG -> ACTGCTAGGGG
AACTGGACGCA -> ACTGGACGCAT
AACTTAATTAG -> ACTTAATTAGG
AACTTATGATG -> ACTTATGATGC
AAGAATTGCCC -> AGAATTGCCCG
AAGACGCCAAT -> AGACGCCAATC
AAGAGTAATAC -> AGAGTAATACT
AAGAGTGGGCG -> AGAGTGGGCGT
AAGCAAAAACA -> AGCAAAAACAA
AAGCAACGTCT -> AGCAACGTCTA
AAGCACCGCTG -> AGCACCGCTGG
AAGCAGTCAGA -> AGCAGTCAGAG
AAGCCAAGAAT -> AGCCAAGAATT
AAGCGAGTTCT -> AGCGAGTTCTC
AAGCGATGTCT -> AGCGATGTCTG
AAGCGGTATGC -> AGCGGTATGCA
AAGCGTAATAC -> AGCGTAATACT
AAGGAGCTCCC -> AGGAGCTCCCA
AAGGAGTGTTA -> AGGAGTGTTAT
AAGGATCGAGT -> AGGATCGAGTC
AAGGATCTTGA -> AGGATCTTGAC
AAGGCGCCCAC -> AGGCGCCCACC
AAGGCGCGGCT -> AGGCGCGGCTA
AAGGCTACTTC -> AGGCTACTTCG
AAGGTCCGACT -> AGGTCCGACTG
AAGGTTAGGCC -> AGGTTAGGCCT
AAGGTTTATAC -> AGGTTTATACC
AAGTACCATTT -> AGTACCATTTG
AAGTATCCGCC -> AGTATCCGCCA
AAGTCCCTACG -> AGTCCCTACGC
AAGTCTAAAGT -> AGTCTAAAGTG
AAGTGCCCGAA -> AGTGCCCGAAG
AAGTGCGACAT -> AGTGCGACATG
AAGTGCTGCCT -> AGTGCTGCCTT
AAGTGGCCTTC -> AGTGGCCTTCG
AAGTGTGCCTG -> AGTGTGCCTGC
AAGTGTGCTGG -> AGTGTGCTGGC
AAGTTCAATGG -> AGTTCAATGGA
AAGTTTCACAC -> AGTTTCACACG
AAGTTTCGGCT -> AGTTTCGGCTT
AAGTTTTAGTA -> AGTTTTAGTAC
AATAACCCGAG -> ATAACCCGAGT
AATACGCAGAC -> ATACGCAGACC
AATACTACCGC -> ATACTACCGCT
AATACTCGAGA -> ATACTCGAGAT
AATAGAACCGT -> ATAGAACCGTC
AATATAATTTA -> ATATAATTTAA
AATATCTGCAC -> ATATCTGCACA
AATCAGTGTCA -> ATCAGTGTCAT
AATCCACGCAT -> ATCCACGCATC
AATCGACCTAT -> ATCGACCTATC
AATCGTATCTT -> ATCGTATCTTA
AATCTATAATA -> ATCTATAATAG
AATCTCAAGCG -> ATCTCAAGCGA
AATGCGCTATA -> ATGCGCTATAT
AATGCTATAAG -> ATGCTATAAGT
AATGGAAAGTG -> ATGGAAAGTGC
AATGTATCATG -> ATGTATCATGG
AATGTGCGTGG -> ATGTGCGTGGA
AATTAGGCTGT -> ATTAGGCTGTT
AATTCGGTGGG -> ATTCGGTGGGG
AATTGACCAGG -> ATTGACCAGGG
AATTGCCCGCG -> ATTGCCCGCGC
AATTTAATTGA -> ATTTAATTGAC
AATTTATTGGT -> ATTTATTGGTA
ACAAACCCTAT -> CAAACCCTATT
ACAAATCTATA -> CAAATCTATAA
ACAACCTTCGT -> CAACCTTCGTC
ACAACTGCTAG -> CAACTGCTAGG
ACAAGACGCCA -> CAAGACGCCAA
ACAAGGTCCGA -> CAAGGTCCGAC
ACAAGGTTAGG -> CAAGGTTAGGC
ACAAGTGCTGC -> CAAGTGCTGCC
ACAAGTGTGCC -> CAAGTGTGCCT
ACAAGTGTGCT -> CAAGTGTGCTG
ACAATAACCCG -> CAATAACCCGA
ACAATATCTGC -> CAATATCTGCA
ACACCGCCTGG -> CACCGCCTGGA
ACACCTTCCAC -> CACCTTCCACA
ACACGGGGAGG -> CACGGGGAGGT
ACACGTCGAAG -> CACGTCGAAGG
ACACGTGCGAG -> CACGTGCGAGG
ACACGTTGTTG -> CACGTTGTTGC
ACACTTACAGG -> CACTTACAGGC
ACACTTCGTTC -> CACTTCGTTCG
ACAGAAAAAAG -> CAGAAAAAAGT
ACAGACACTTA -> CAGACACTTAC
ACAGACTCGGT -> CAGACTCGGTT
ACAGGCTCGGG -> CAGGCTCGGGT
ACAGTGAGCGG -> CAGTGAGCGGG
ACATCATCTAG -> CATCATCTAGT
ACATGACACTT -> CATGACACTTC
ACATGATTGGA -> CATGATTGGAT
ACATGCGGGCT -> CATGCGGGCTG
ACATGCTAAGC -> CATGCTAAGCC
ACATGGACAAG -> CATGGACAAGT
ACATTATAAGT -> CATTATAAGTT
ACCAAGCAGTC -> CCAAGCAGTCA
ACCACGATGGA -> CCACGATGGAC
ACCAGGGAGCG -> CCAGGGAGCGT
ACCAGGTTATG -> CCAGGTTATGT
ACCATGCGCTC -> CCATGCGCTCT
ACCATTTGCAC -> CCATTTGCACG
ACCCAGGGATG -> CCCAGGGATGG
ACCCCAGCACA -> CCCCAGCACAA
ACCCGAGTTCC -> CCCGAGTTCCC
ACCCTATTTCG -> CCCTATTTCGC
ACCCTCTGTCG -> CCCTCTGTCGG
ACCCTTAGAGT -> CCCTTAGAGTG
ACCCTTAGTCG -> CCCTTAGTCGA
ACCGACTCTCC -> CCGACTCTCCA
ACCGCCTGGAC -> CCGCCTGGACG
ACCGCTGGCTA -> CCGCTGGCTAC
ACCGCTTGAAG -> CCGCTTGAAGT
ACCGTATAGGT -> CCGTATAGGTC
ACCGTCTGTAA -> CCGTCTGTAAC
ACCGTTTCATC -> CCGTTTCATCC
ACCTAGGAAAA -> CCTAGGAAAAC
ACCTAGGGTAC -> CCTAGGGTACT
ACCTATCGTCG -> CCTATCGTCGC
ACCTCCAACAA -> CCTCCAACAAT
ACCTCGAATGC -> CCTCGAATGCT
ACCTCTAGAAT -> CCTCTAGAATC
ACCTCTGTGAA -> CCTCTGTGAAT
ACCTTCCACAT -> CCTTCCACATT
ACGAAGGAGCT -> CGAAGGAGCTC
ACGAATGTGCG -> CGAATGTGCGT
ACGACTAGTAT -> CGACTAGTATC
ACGATGGACTC -> CGATGGACTCT
ACGATGTGAGA -> CGATGTGAGAG
ACGCAGACCTC -> CGCAGACCTCT
ACGCATCAAGG -> CGCATCAAGGA
ACGCATCTAGA -> CGCATCTAGAG
ACGCCAATCTC -> CGCCAATCTCA
ACGCCCGAACC -> CGCCCGAACCG
ACGCCTCGACA -> CGCCTCGACAC
ACGCGCAACCC -> CGCGCAACCCT
ACGCTAAGGCG -> CGCTAAGGCGC
ACGCTGCCATT -> CGCTGCCATTG
ACGCTGTGGTC -> CGCTGTGGTCC
ACGGACCTAGG -> CGGACCTAGGA
ACGGAGACATC -> CGGAGACATCA
ACGGAGTCGCA -> CGGAGTCGCAT
ACGGGGACGAC -> CGGGGACGACT
ACGGGGAGGTG -> CGGGGAGGTGC
ACGGGGATGTG -> CGGGGATGTGC
ACGGGGTATAC -> CGGGGTATACA
ACGGTAAGCGG -> CGGTAAGCGGT
ACGTAACTGCG -> CGTAACTGCGC
ACGTATCTCCT -> CGTATCTCCTT
ACGTATGTACA -> CGTATGTACAG
ACGTCAGTTAT -> CGTCAGTTATA
ACGTCGAAGGA -> CGTCGAAGGAG
ACGTCGCCTGT -> CGTCGCCTGTC
ACGTCTAACGC -> CGTCTAACGCT
ACGTGATACTT -> CGTGATACTTC
ACGTGCGAGGT -> CGTGCGAGGTT
ACGTTGTTGCA -> CGTTGTTGCAG
ACTACCGCTTG -> CTACCGCTTGA
ACTACGCTGTG -> CTACGCTGTGG
ACTAGTATCGC -> CTAGTATCGCT
ACTCATCCGGT -> CTCATCCGGTA
ACTCATCTTGT -> CTCATCTTGTG
ACTCCATGTTT -> CTCCATGTTTT
ACTCGAGATCG -> CTCGAGATCGT
ACTCGGTGAGC -> CTCGGTGAGCA
ACTCGGTTAAT -> CTCGGTTAATC
ACTCTCCATAA -> CTCTCCATAAC
ACTCTTATACT -> CTCTTATACTT
ACTCTTCACAC -> CTCTTCACACG
ACTGCGCGGGC -> CTGCGCGGGCG
ACTGCTAGGGG -> CTGCTAGGGGA
ACTGGACGCAT -> CTGGACGCATC
ACTGTGCTCAT -> CTGTGCTCATA
ACTGTGTGAGA -> CTGTGTGAGAT
ACTTAATTAGG -> CTTAATTAGGC
ACTTACAGGCT -> CTTACAGGCTC
ACTTATGATGC -> CTTATGATGCT
ACTTATTTATA -> CTTATTTATAT
ACTTCAAGTCT -> CTTCAAGTCTA
ACTTCGATTCT -> CTTCGATTCTT
ACTTCGGATCA -> CTTCGGATCAG
ACTTCGGGACA -> CTTCGGGACAA
ACTTCGTTCGA -> CTTCGTTCGAT
ACTTGGCCGGC -> CTTGGCCGGCG
ACTTTTTTACC -> CTTTTTTACCA
AGAAAAAAGTA -> GAAAAAAGTAC
AGAACCGTCTG -> GAACCGTCTGT
AGAAGTTTCGG -> GAAGTTTCGGC
AGAATCGTATC -> GAATCGTATCT
AGAATTGCCCG -> GAATTGCCCGC
AGACACGGGGA -> GACACGGGGAG
AGACACTTACA -> GACACTTACAG
AGACATCATCT -> GACATCATCTA
AGACCTCTAGA -> GACCTCTAGAA
AGACGCCAATC -> GACGCCAATCT
AGACGTCGCCT -> GACGTCGCCTG
AGACTCGGTTA -> GACTCGGTTAA
AGAGACGTCGC -> GAGACGTCGCC
AGAGAGGTTGA -> GAGAGGTTGAC
AGAGAGTTCTT -> GAGAGTTCTTT
AGAGGTTGACA -> GAGGTTGACAA
AGAGTAATACT -> GAGTAATACTA
AGAGTGGGCGT -> GAGTGGGCGTC
AGAGTGTCCTC -> GAGTGTCCTCC
AGAGTTCTTTC -> GAGTTCTTTCA
AGATCGTGGGA -> GATCGTGGGAC
AGATGGTGATC -> GATGGTGATCT
AGCAAAAACAA -> GCAAAAACAAG
AGCAACGTCTA -> GCAACGTCTAA
AGCACAAGACG -> GCACAAGACGC
AGCACCGCTGG -> GCACCGCTGGC
AGCACGCCTCG -> GCACGCCTCGA
AGCAGTCAGAG -> GCAGTCAGAGA
AGCCAAGAATT -> GCCAAGAATTG
AGCCATGGTAC -> GCCATGGTACG
AGCCCCCCTCC -> GCCCCCCTCCT
AGCCGGCGGGA -> GCCGGCGGGAC
AGCCTCGTTAA -> GCCTCGTTAAA
AGCGAGTTCTC -> GCGAGTTCTCC
AGCGATGTCTG -> GCGATGTCTGG
AGCGGGCTGAT -> GCGGGCTGATT
AGCGGTATGCA -> GCGGTATGCAT
AGCGTAATACT -> GCGTAATACTC
AGCGTGTAGGC -> GCGTGTAGGCT
AGCGTGTCCCA -> GCGTGTCCCAC
AGCTACCCTTA -> GCTACCCTTAG
AGCTACCTAGG -> GCTACCTAGGG
AGCTCCCAAGC -> GCTCCCAAGCG
AGCTCTCCCTC -> GCTCTCCCTCT
AGCTGCATGGG -> GCTGCATGGGA
AGGAAAACGCG -> GGAAAACGCGC
AGGAAATACGC -> GGAAATACGCA
AGGACTTTTTT -> GGACTTTTTTA
AGGAGCTCCCA -> GGAGCTCCCAA
AGGAGTGTTAT -> GGAGTGTTATT
AGGATCGAGTC -> GGATCGAGTCG
AGGATCTTGAC -> GGATCTTGACG
AGGCCCAAGCA -> GGCCCAAGCAC
AGGCCTTCTTT -> GGCCTTCTTTT
AGGCGCCCACC -> GGCGCCCACCT
AGGCGCGGCTA -> GGCGCGGCTAG
AGGCTACTTCG -> GGCTACTTCGG
AGGCTCGGGTT -> GGCTCGGGTTA
AGGCTGTTGAC -> GGCTGTTGACA
AGGCTTCGTCA -> GGCTTCGTCAA
AGGGAGCGTGT -> GGGAGCGTGTA
AGGGAGGAAAT -> GGGAGGAAATA
AGGGATGGTGA -> GGGATGGTGAC
AGGGGAGCCTC -> GGGGAGCCTCG
AGGGGCTAACA -> GGGGCTAACAT
AGGGTACTCAT -> GGGTACTCATC
AGGTACTCGGT -> GGTACTCGGTG
AGGTATACCTC -> GGTATACCTCC
AGGTCAACTCT -> GGTCAACTCTT
AGGTCCACTAC -> GGTCCACTACG
AGGTCCGACTG -> GGTCCGACTGT
AGGTCTATAAT -> GGTCTATAATT
AGGTGCGGCAC -> GGTGCGGCACG
AGGTGTTCGGT -> GGTGTTCGGTC
AGGTTAGGCCT -> GGTTAGGCCTT
AGGTTATGTTC -> GGTTATGTTCG
AGGTTGACAAC -> GGTTGACAACC
AGGTTTATACC -> GGTTTATACCA
AGGTTTGGGTT -> GGTTTGGGTTT
AGTAATACTAC -> GTAATACTACC
AGTACAGTGAG -> GTACAGTGAGC
AGTACCATTTG -> GTACCATTTGC
AGTATCCGCCA -> GTATCCGCCAC
AGTATCGCTCT -> GTATCGCTCTA
AGTATTGCTCT -> GTATTGCTCTT
AGTCAGAGAGG -> GTCAGAGAGGT
AGTCCCTACGC -> GTCCCTACGCC
AGTCGAAGCAA -> GTCGAAGCAAC
AGTCGATGTTT -> GTCGATGTTTC
AGTCGCATCTC -> GTCGCATCTCA
AGTCGGATCGA -> GTCGGATCGAT
AGTCTAAAGTG -> GTCTAAAGTGC
AGTCTATTAAA -> GTCTATTAAAC
AGTGAGCGGGC -> GTGAGCGGGCT
AGTGCCCGAAG -> GTGCCCGAAGG
AGTGCGACATG -> GTGCGACATGC
AGTGCTGCCTT -> GTGCTGCCTTC
AGTGGCCTTCG -> GTGGCCTTCGG
AGTGGGCGTCT -> GTGGGCGTCTG
AGTGGTTTATT -> GTGGTTTATTG
AGTGTCATTGC -> GTGTCATTGCT
AGTGTCCTCCT -> GTGTCCTCCTC
AGTGTGCCTGC -> GTGTGCCTGCG
AGTGTGCTGGC -> GTGTGCTGGCT
AGTGTTATTGG -> GTGTTATTGGC
AGTTATAGCGT -> GTTATAGCGTG
AGTTCAATGGA -> GTTCAATGGAA
AGTTCCCAAGT -> GTTCCCAAGTT
AGTTCTCCATG -> GTTCTCCATGA
AGTTCTTTCAG -> GTTCTTTCAGG
AGTTTCACACG -> GTTTCACACGT
AGTTTCGGCTT -> GTTTCGGCTTA
AGTTTTAGTAC -> GTTTTAGTACA
ATAACAAGGTT -> TAACAAGGTTA
ATAACCCGAGT -> TAACCCGAGTT
ATAACGGAGAC -> TAACGGAGACA
ATAAGTGGCCT -> TAAGTGGCCTT
ATAAGTTTCAC -> TAAGTTTCACA
ATAATAGAACC -> TAATAGAACCG
ATAATTCGGTG -> TAATTCGGTGG
ATAATTTAATT -> TAATTTAATTG
ATACAAGGTCC -> TACAAGGTCCG
ATACAAGTGTG -> TACAAGTGTGC
ATACACCTTCC -> TACACCTTCCA
ATACCACGATG -> TACCACGATGG
ATACCTCCAAC -> TACCTCCAACA
ATACCTCGAAT -> TACCTCGAATG
ATACGCAGACC -> TACGCAGACCT
ATACGGACCTA -> TACGGACCTAG
ATACGTCAGTT -> TACGTCAGTTA
ATACTACCGCT -> TACTACCGCTT
ATACTCGAGAT -> TACTCGAGATC
ATACTTCAAGT -> TACTTCAAGTC
ATACTTCGGAT -> TACTTCGGATC
ATAGAACCGTC -> TAGAACCGTCT
ATAGCGTGTCC -> TAGCGTGTCCC
ATAGCTGCATG -> TAGCTGCATGG
ATAGGACTTTT -> TAGGACTTTTT
ATAGGTATACC -> TAGGTATACCT
ATAGGTCCACT -> TAGGTCCACTA
ATATAATTTAA -> TATAATTTAAT
ATATATGGTTG -> TATATGGTTGT
ATATCTGCACA -> TATCTGCACAA
ATATGAATTTA -> TATGAATTTAT
ATATGGTTGTA -> TATGGTTGTAG
ATATTAGGTAC -> TATTAGGTACT
ATCAAGGATCG -> TCAAGGATCGA
ATCAATCCACG -> TCAATCCACGC
ATCAGTATTGC -> TCAGTATTGCT
ATCAGTGTCAT -> TCAGTGTCATT
ATCATCTAGTG -> TCATCTAGTGG
ATCATGGTCAT -> TCATGGTCATC
ATCCACGCATC -> TCCACGCATCA
ATCCATTTGGA -> TCCATTTGGAG
ATCCGCCACGG -> TCCGCCACGGT
ATCCGGTATTC -> TCCGGTATTCA
ATCCTTAAACC -> TCCTTAAACCA
ATCGACCTATC -> TCGACCTATCG
ATCGAGTCGGA -> TCGAGTCGGAT
ATCGATACGTC -> TCGATACGTCA
ATCGCTCTATA -> TCGCTCTATAG
ATCGGGCGAAG -> TCGGGCGAAGG
ATCGGTTCCAC -> TCGGTTCCACA
ATCGTATCTTA -> TCGTATCTTAC
ATCGTCGCCTG -> TCGTCGCCTGT
ATCGTGGGACC -> TCGTGGGACCC
ATCTAGAGACG -> TCTAGAGACGT
ATCTAGTGGTT -> TCTAGTGGTTT
ATCTATAATAG -> TCTATAATAGA
ATCTCAAGCGA -> TCTCAAGCGAG,TCTCAAGCGAT
ATCTCCTTCAC -> TCTCCTTCACT
ATCTGCACAAA -> TCTGCACAAAC
ATCTTAAACTG -> TCTTAAACTGG
ATCTTACTTGG -> TCTTACTTGGC
ATCTTGACGTA -> TCTTGACGTAT
ATCTTGTGTGC -> TCTTGTGTGCC
ATGAAGAGTAA -> TGAAGAGTAAT
ATGAATGCGCT -> TGAATGCGCTA
ATGAATTTATT -> TGAATTTATTG
ATGACACTTCG -> TGACACTTCGT
ATGATGCTCAT -> TGATGCTCATG
ATGATTGGATA -> TGATTGGATAA
ATGCATAGGAC -> TGCATAGGACT
ATGCGCTATAT -> TGCGCTATATG
ATGCGCTCTGG -> TGCGCTCTGGA
ATGCGGGCTGG -> TGCGGGCTGGG
ATGCTAAGCCA -> TGCTAAGCCAA
ATGCTATAAGT -> TGCTATAAGTG
ATGCTCATGTC -> TGCTCATGTCC
ATGGAAAGTGC -> TGGAAAGTGCC
ATGGACAAGTG -> TGGACAAGTGT
ATGGACTCTTC -> TGGACTCTTCA
ATGGGATTGTG -> TGGGATTGTGG
ATGGTACGTAT -> TGGTACGTATG
ATGGTCATCGG -> TGGTCATCGGG
ATGGTGACCAT -> TGGTGACCATG
ATGGTGATCTT -> TGGTGATCTTA
ATGGTTGTAGC -> TGGTTGTAGCT
ATGTACAGAAA -> TGTACAGAAAA
ATGTATCATGG -> TGTATCATGGT
ATGTCCATACA -> TGTCCATACAA
ATGTCTGGGGC -> TGTCTGGGGCA
ATGTGAGAGAG -> TGTGAGAGAGT
ATGTGCCCATA -> TGTGCCCATAC
ATGTGCGTGGA -> TGTGCGTGGAT
ATGTGTTTTAC -> TGTGTTTTACC
ATGTTCGTGGC -> TGTTCGTGGCT
ATGTTTCGTCT -> TGTTTCGTCTC
ATGTTTTCGTT -> TGTTTTCGTTA
ATTAAACTTAA -> TTAAACTTAAT
ATTAACATGGA -> TTAACATGGAC
ATTACGGGGAC -> TTACGGGGACG
ATTAGGCCCAA -> TTAGGCCCAAG
ATTAGGCTGTT -> TTAGGCTGTTG
ATTAGGTACTC -> TTAGGTACTCG
ATTATAAGTTT -> TTATAAGTTTC
ATTATGAATGC -> TTATGAATGCG
ATTCAGAAGTT -> TTCAGAAGTTT
ATTCAGGGAGG -> TTCAGGGAGGA
ATTCGGTGGGG -> TTCGGTGGGGG
ATTCTTTGCGC -> TTCTTTGCGCA
ATTGACCAGGG -> TTGACCAGGGA
ATTGATTAACA -> TTGATTAACAT
ATTGATTTTGC -> TTGATTTTGCG
ATTGCCCGCGC -> TTGCCCGCGCG
ATTGCTCTTGG -> TTGCTCTTGGA
ATTGCTTCGTA -> TTGCTTCGTAG
ATTGGATAACA -> TTGGATAACAA
ATTGGCGCTTA -> TTGGCGCTTAT
ATTGGTAAGGC -> TTGGTAAGGCG
ATTGTGGACAC -> TTGTGGACACC
ATTGTTTTCAA -> TTGTTTTCAAG
ATTTAATTGAC -> TTTAATTGACC
ATTTATATTAG -> TTTATATTAGG
ATTTATTGGTA -> TTTATTGGTAA
ATTTCGCCACT -> TTTCGCCACTC
ATTTGCACGAA -> TTTGCACGAAT
ATTTGGAGACA -> TTTGGAGACAC
ATTTTGCGAAG -> TTTTGCGAAGG
CAAAAACAAGT -> AAAAACAAGTG
CAAACCCTATT -> AAACCCTATTT
CAAATCTATAA -> AAATCTATAAT
CAACAATATCT -> AACAATATCTG
CAACATGATTG -> AACATGATTGG
CAACCCTTAGA -> AACCCTTAGAG
CAACCTTCGTC -> AACCTTCGTCT
CAACGTCTAAC -> AACGTCTAACG
CAACTCTTATA -> AACTCTTATAC
CAACTGCTAGG -> AACTGCTAGGG
CAAGAATTGCC -> AAGAATTGCCC
CAAGACGCCAA -> AAGACGCCAAT
CAAGCAAAAAC -> AAGCAAAAACA
CAAGCACCGCT -> AAGCACCGCTG
CAAGCAGTCAG -> AAGCAGTCAGA
CAAGCGAGTTC -> AAGCGAGTTCT
CAAGCGATGTC -> AAGCGATGTCT
CAAGCGTAATA -> AAGCGTAATAC
CAAGGATCGAG -> AAGGATCGAGT
CAAGGTCCGAC -> AAGGTCCGACT
CAAGGTTAGGC -> AAGGTTAGGCC
CAAGTCTAAAG -> AAGTCTAAAGT
CAAGTGCTGCC -> AAGTGCTGCCT
CAAGTGTGCCT -> AAGTGTGCCTG
CAAGTGTGCTG -> AAGTGTGCTGG
CAAGTTTTAGT -> AAGTTTTAGTA
CAATAACCCGA -> AATAACCCGAG
CAATATCTGCA -> AATATCTGCAC
CAATCCACGCA -> AATCCACGCAT
CAATCGACCTA -> AATCGACCTAT
CAATCTCAAGC -> AATCTCAAGCG
CAATGGAAAGT -> AATGGAAAGTG
CACAAACCCTA -> ACAAACCCTAT
CACAACTGCTA -> ACAACTGCTAG
CACAAGACGCC -> ACAAGACGCCA
CACAATAACCC -> ACAATAACCCG
CACACGTGCGA -> ACACGTGCGAG
CACACGTTGTT -> ACACGTTGTTG
CACAGACACTT -> ACAGACACTTA
CACATTATAAG -> ACATTATAAGT
CACCGCCTGGA -> ACCGCCTGGAC
CACCGCTGGCT -> ACCGCTGGCTA
CACCTCTGTGA -> ACCTCTGTGAA
CACCTTCCACA -> ACCTTCCACAT
CACGAATGTGC -> ACGAATGTGCG
CACGATGGACT -> ACGATGGACTC
CACGCATCAAG -> ACGCATCAAGG
CACGCCTCGAC -> ACGCCTCGACA
CACGGAGTCGC -> ACGGAGTCGCA
CACGGGGAGGT -> ACGGGGAGGTG
CACGGGGTATA -> ACGGGGTATAC
CACGGTAAGCG -> ACGGTAAGCGG
CACGTCGAAGG -> ACGTCGAAGGA
CACGTGATACT -> ACGTGATACTT
CACGTGCGAGG -> ACGTGCGAGGT
CACGTTGTTGC -> ACGTTGTTGCA
CACTACGCTGT -> ACTACGCTGTG
CACTCATCCGG -> ACTCATCCGGT
CACTTACAGGC -> ACTTACAGGCT
CACTTATTTAT -> ACTTATTTATA
CACTTCGTTCG -> ACTTCGTTCGA
CAGAAAAAAGT -> AGAAAAAAGTA
CAGAAGTTTCG -> AGAAGTTTCGG
CAGACACTTAC -> AGACACTTACA
CAGACCTCTAG -> AGACCTCTAGA
CAGACTCGGTT -> AGACTCGGTTA
CAGAGAGGTTG -> AGAGAGGTTGA
CAGCACAAGAC -> AGCACAAGACG
CAGGCTCGGGT -> AGGCTCGGGTT
CAGGGAGCGTG -> AGGGAGCGTGT
CAGGGAGGAAA -> AGGGAGGAAAT
CAGGGATGGTG -> AGGGATGGTGA
CAGGGGCTAAC -> AGGGGCTAACA
CAGGTCAACTC -> AGGTCAACTCT
CAGGTGTTCGG -> AGGTGTTCGGT
CAGGTTATGTT -> AGGTTATGTTC
CAGTATTGCTC -> AGTATTGCTCT
CAGTCAGAGAG -> AGTCAGAGAGG
CAGTCTATTAA -> AGTCTATTAAA
CAGTGAGCGGG -> AGTGAGCGGGC
CAGTGTCATTG -> AGTGTCATTGC
CAGTTATAGCG -> AGTTATAGCGT
CATAACGGAGA -> ATAACGGAGAC
CATACAAGGTC -> ATACAAGGTCC
CATACAAGTGT -> ATACAAGTGTG
CATAGGACTTT -> ATAGGACTTTT
CATAGGTATAC -> ATAGGTATACC
CATCAAGGATC -> ATCAAGGATCG
CATCATCTAGT -> ATCATCTAGTG
CATCCGGTATT -> ATCCGGTATTC
CATCCTTAAAC -> ATCCTTAAACC
CATCGGGCGAA -> ATCGGGCGAAG
CATCTAGAGAC -> ATCTAGAGACG
CATCTAGTGGT -> ATCTAGTGGTT
CATCTCAAGCG -> ATCTCAAGCGA
CATCTTGTGTG -> ATCTTGTGTGC
CATGAAGAGTA -> ATGAAGAGTAA
CATGACACTTC -> ATGACACTTCG
CATGATTGGAT -> ATGATTGGATA
CATGCGCTCTG -> ATGCGCTCTGG
CATGCGGGCTG -> ATGCGGGCTGG
CATGCTAAGCC -> ATGCTAAGCCA
CATGGACAAGT -> ATGGACAAGTG
CATGGGATTGT -> ATGGGATTGTG
CATGGTACGTA -> ATGGTACGTAT
CATGGTCATCG -> ATGGTCATCGG
CATGTCCATAC -> ATGTCCATACA
CATGTTTTCGT -> ATGTTTTCGTT
CATTAGGCCCA -> ATTAGGCCCAA
CATTATAAGTT -> ATTATAAGTTT
CATTGATTTTG -> ATTGATTTTGC
CATTGCTTCGT -> ATTGCTTCGTA
CATTTGCACGA -> ATTTGCACGAA
CATTTGGAGAC -> ATTTGGAGACA
CCAACAATATC -> CAACAATATCT
CCAAGAATTGC -> CAAGAATTGCC
CCAAGCACCGC -> CAAGCACCGCT
CCAAGCAGTCA -> CAAGCAGTCAG
CCAAGCGTAAT -> CAAGCGTAATA
CCAAGTTTTAG -> CAAGTTTTAGT
CCAATCTCAAG -> CAATCTCAAGC
CCACAACTGCT -> CACAACTGCTA
CCACAATAACC -> CACAATAACCC
CCACATTATAA -> CACATTATAAG
CCACCTCTGTG -> CACCTCTGTGA
CCACGATGGAC -> CACGATGGACT
CCACGCATCAA -> CACGCATCAAG
CCACGGGGTAT -> CACGGGGTATA
CCACGGTAAGC -> CACGGTAAGCG
CCACTACGCTG -> CACTACGCTGT
CCACTCATCCG -> CACTCATCCGG
CCAGCACAAGA -> CAGCACAAGAC
CCAGGGAGCGT -> CAGGGAGCGTG
CCAGGGATGGT -> CAGGGATGGTG
CCAGGTCAACT -> CAGGTCAACTC
CCAGGTTATGT -> CAGGTTATGTT
CCATAACGGAG -> CATAACGGAGA
CCATACAAGGT -> CATACAAGGTC
CCATACAAGTG -> CATACAAGTGT
CCATGAAGAGT -> CATGAAGAGTA
CCATGCGCTCT -> CATGCGCTCTG
CCATGGTACGT -> CATGGTACGTA
CCATGTTTTCG -> CATGTTTTCGT
CCATTGATTTT -> CATTGATTTTG
CCATTTGCACG -> CATTTGCACGA
CCATTTGGAGA -> CATTTGGAGAC
CCCAAGCACCG -> CCAAGCACCGC
CCCAAGCGTAA -> CCAAGCGTAAT
CCCAAGTTTTA -> CCAAGTTTTAG
CCCACCTCTGT -> CCACCTCTGTG
CCCACGGGGTA -> CCACGGGGTAT
CCCAGCACAAG -> CCAGCACAAGA
CCCAGGGATGG -> CCAGGGATGGT
CCCATACAAGT -> CCATACAAGTG
CCCCAGCACAA -> CCCAGCACAAG
CCCCCCTCCTG -> CCCCCTCCTGG
CCCCCTCCTGG -> CCCCTCCTGGG
CCCCTCCTGGG -> CCCTCCTGGGA
CCCGAACCGTA -> CCGAACCGTAT
CCCGAAGGCTA -> CCGAAGGCTAC
CCCGAGTTCCC -> CCGAGTTCCCA
CCCGCGCGCCT -> CCGCGCGCCTT
CCCGGACGTAA -> CCGGACGTAAC
CCCTACGCCCG -> CCTACGCCCGA
CCCTATTTCGC -> CCTATTTCGCC
CCCTCCTGGGA -> CCTCCTGGGAT
CCCTCTAGGTC -> CCTCTAGGTCT
CCCTCTGTCGG -> CCTCTGTCGGT
CCCTTAGAGTG -> CCTTAGAGTGT
CCCTTAGTCGA -> CCTTAGTCGAT
CCCTTCCGCTC -> CCTTCCGCTCA
CCGAACCGTAT -> CGAACCGTATA
CCGAAGGCTAC -> CGAAGGCTACT
CCGACTCTCCA -> CGACTCTCCAT
CCGACTGTGTG -> CGACTGTGTGA
CCGAGTTCCCA -> CGAGTTCCCAA
CCGCCACGGTA -> CGCCACGGTAA
CCGCCTGGACG -> CGCCTGGACGA
CCGCGCGCCTT -> CGCGCGCCTTA
CCGCTCACGGA -> CGCTCACGGAG
CCGCTGGCTAC -> CGCTGGCTACT
CCGCTTGAAGT -> CGCTTGAAGTT
CCGGACGTAAC -> CGGACGTAACT
CCGGCGATCCA -> CGGCGATCCAT
CCGGCGGGACA -> CGGCGGGACAG
CCGGTATTCAG -> CGGTATTCAGG
CCGTATAGGTC -> CGTATAGGTCC
CCGTCTGTAAC -> CGTCTGTAACT
CCGTTATACCT -> CGTTATACCTC
CCGTTTCATCC -> CGTTTCATCCT
CCTACGCCCGA -> CTACGCCCGAA
CCTAGCTACCT -> CTAGCTACCTA
CCTAGGAAAAC -> CTAGGAAAACG
CCTAGGGTACT -> CTAGGGTACTC
CCTATCGTCGC -> CTATCGTCGCC
CCTATTTCGCC -> CTATTTCGCCA
CCTCCAACAAT -> CTCCAACAATA
CCTCCTCGAGC -> CTCCTCGAGCC
CCTCCTGGGAT -> CTCCTGGGATC
CCTCGAATGCT -> CTCGAATGCTA
CCTCGACACGT -> CTCGACACGTC
CCTCGAGCCCC -> CTCGAGCCCCC
CCTCGTTAAAC -> CTCGTTAAACT
CCTCTAGAATC -> CTCTAGAATCG
CCTCTAGGTCT -> CTCTAGGTCTA
CCTCTGTCGGT -> CTCTGTCGGTC
CCTCTGTGAAT -> CTCTGTGAATG
CCTGCGGCTCG -> CTGCGGCTCGA
CCTGGACGAAG -> CTGGACGAAGG
CCTGGGATCGG -> CTGGGATCGGT
CCTGTCGCGTG -> CTGTCGCGTGC
CCTGTTTATTA -> CTGTTTATTAT
CCTTAAACCAA -> CTTAAACCAAG
CCTTAGAGTGT -> CTTAGAGTGTC
CCTTAGCTACC -> CTTAGCTACCC
CCTTAGTCGAT -> CTTAGTCGATG
CCTTCACTTAT -> CTTCACTTATT
CCTTCCACATT -> CTTCCACATTA
CCTTCCGCTCA -> CTTCCGCTCAC
CCTTCGACCCA -> CTTCGACCCAG
CCTTCGGCCAG -> CTTCGGCCAGG
CCTTCTTTTTT -> CTTCTTTTTTG
CGAACCGTATA -> GAACCGTATAG
CGAAGCAACGT -> GAAGCAACGTC
CGAAGGAGCTC -> GAAGGAGCTCC
CGAAGGAGTGT -> GAAGGAGTGTT
CGAAGGATCTT -> GAAGGATCTTG
CGAAGGCTACT -> GAAGGCTACTT
CGAAGGTTTAT -> GAAGGTTTATA
CGAATGCTATA -> GAATGCTATAA
CGAATGTGCGT -> GAATGTGCGTG
CGACACGTCGA -> GACACGTCGAA
CGACATGCGGG -> GACATGCGGGC
CGACCCAGGGA -> GACCCAGGGAT
CGACCTATCGT -> GACCTATCGTC
CGACTAGTATC -> GACTAGTATCG
CGACTCTCCAT -> GACTCTCCATA
CGACTGTGTGA -> GACTGTGTGAG
CGACTTCGATT -> GACTTCGATTC
CGAGATCGTGG -> GAGATCGTGGG
CGAGCCCCCCT -> GAGCCCCCCTC
CGAGGTTTGGG -> GAGGTTTGGGT
CGAGTCGGATC -> GAGTCGGATCG
CGAGTTCCCAA -> GAGTTCCCAAG
CGAGTTCTCCA -> GAGTTCTCCAT
CGATACGTCAG -> GATACGTCAGT
CGATCCATTTG -> GATCCATTTGG
CGATGGACTCT -> GATGGACTCTT
CGATGTCTGGG -> GATGTCTGGGG
CGATGTGAGAG -> GATGTGAGAGA
CGATGTGTTTT -> GATGTGTTTTA
CGATGTTTCGT -> GATGTTTCGTC
CGATTCAGAAG -> GATTCAGAAGT
CGATTCTTTGC -> GATTCTTTGCG
CGCAACATGAT -> GCAACATGATT
CGCAACCCTTA -> GCAACCCTTAG
CGCACAGACAC -> GCACAGACACT
CGCAGACCTCT -> GCAGACCTCTA
CGCATCAAGGA -> GCATCAAGGAT
CGCATCTAGAG -> GCATCTAGAGA
CGCATCTCAAG -> GCATCTCAAGC
CGCCAATCTCA -> GCCAATCTCAA
CGCCACGGTAA -> GCCACGGTAAG
CGCCACTCATC -> GCCACTCATCC
CGCCCACCTCT -> GCCCACCTCTG
CGCCCGAACCG -> GCCCGAACCGT
CGCCTCGACAC -> GCCTCGACACG
CGCCTGGACGA -> GCCTGGACGAA
CGCCTGTCGCG -> GCCTGTCGCGT
CGCCTGTTTAT -> GCCTGTTTATT
CGCCTTAGCTA -> GCCTTAGCTAC
CGCGCAACCCT -> GCGCAACCCTT
CGCGCCTTAGC -> GCGCCTTAGCT
CGCGCGCCTTA -> GCGCGCCTTAG
CGCGGCTAGCC -> GCGGCTAGCCA
CGCGGGCGCAA -> GCGGGCGCAAC
CGCGTGCCTAG -> GCGTGCCTAGC
CGCTAAGGCGC -> GCTAAGGCGCG
CGCTATATGAA -> GCTATATGAAT
CGCTCACGGAG -> GCTCACGGAGT
CGCTCTATAGC -> GCTCTATAGCT
CGCTCTGGACG -> GCTCTGGACGC
CGCTGCCATTG -> GCTGCCATTGA
CGCTGGCTACT -> GCTGGCTACTG
CGCTGTGGTCC -> GCTGTGGTCCC
CGCTTATCAAT -> GCTTATCAATC
CGCTTGAAGTT -> GCTTGAAGTTC
CGGACCTAGGA -> GGACCTAGGAA
CGGACGTAACT -> GGACGTAACTG
CGGAGACATCA -> GGAGACATCAT
CGGAGTCGCAT -> GGAGTCGCATC
CGGATCAGTAT -> GGATCAGTATT
CGGATCGATAC -> GGATCGATACG
CGGCACGTGAT -> GGCACGTGATA
CGGCCAGGTCA -> GGCCAGGTCAA
CGGCGATCCAT -> GGCGATCCATT
CGGCGGGACAG -> GGCGGGACAGA
CGGCTAGCCAT -> GGCTAGCCATG
CGGCTCGATTC -> GGCTCGATTCA
CGGCTTAGCCG -> GGCTTAGCCGG
CGGGACAAATC -> GGGACAAATCT
CGGGACAGACT -> GGGACAGACTC
CGGGCGAAGGA -> GGGCGAAGGAT
CGGGCGCAACA -> GGGCGCAACAT
CGGGCTGATTA -> GGGCTGATTAC
CGGGCTGGGAA -> GGGCTGGGAAG
CGGGGACGACT -> GGGGACGACTA
CGGGGAGGTGC -> GGGGAGGTGCG
CGGGGATGTGC -> GGGGATGTGCC
CGGGGTATACA -> GGGGTATACAC
CGGGTTACCGA -> GGGTTACCGAC
CGGTAAGCGGT -> GGTAAGCGGTA
CGGTATGCATA -> GGTATGCATAG
CGGTATTCAGG -> GGTATTCAGGG
CGGTCGACTTC -> GGTCGACTTCG
CGGTCTGTTGA -> GGTCTGTTGAT
CGGTGAGCACG -> GGTGAGCACGC
CGGTGGGGGAT -> GGTGGGGGATT
CGGTTAATCAG -> GGTTAATCAGT
CGGTTCCACAA -> GGTTCCACAAT
CGTAACTGCGC -> GTAACTGCGCG
CGTAATACTCG -> GTAATACTCGA
CGTAGTCGAAG -> GTAGTCGAAGC
CGTATAGGTCC -> GTATAGGTCCA
CGTATCTCCTT -> GTATCTCCTTC
CGTATCTTACT -> GTATCTTACTT
CGTATGTACAG -> GTATGTACAGA
CGTCAATCGAC -> GTCAATCGACC
CGTCAGTTATA -> GTCAGTTATAG
CGTCGAAGGAG -> GTCGAAGGAGT
CGTCGCCTGTC -> GTCGCCTGTCG
CGTCGCCTGTT -> GTCGCCTGTTT
CGTCTAACGCT -> GTCTAACGCTG
CGTCTCCACAA -> GTCTCCACAAC
CGTCTGGCTGG -> GTCTGGCTGGA
CGTCTGTAACT -> GTCTGTAACTT
CGTGATACTTC -> GTGATACTTCA
CGTGCCTAGCT -> GTGCCTAGCTA
CGTGCGAGGTT -> GTGCGAGGTTT
CGTGGATACGG -> GTGGATACGGA
CGTGGCTCCCT -> GTGGCTCCCTT
CGTGGGACCCC -> GTGGGACCCCA
CGTGTAGGCTT -> GTGTAGGCTTC
CGTGTCCCACG -> GTGTCCCACGG
CGTTAAACTCC -> GTTAAACTCCA
CGTTAAATATA -> GTTAAATATAA
CGTTATACCTC -> GTTATACCTCG
CGTTCGATGTG -> GTTCGATGTGT
CGTTGTTGCAG -> GTTGTTGCAGT
CGTTTCATCCT -> GTTTCATCCTT
CTAAAGTGCGA -> TAAAGTGCGAC
CTAACATGCTA -> TAACATGCTAA
CTAACGCTGCC -> TAACGCTGCCA
CTAAGCCAAGA -> TAAGCCAAGAA
CTAAGGCGCGG -> TAAGGCGCGGC
CTACCCTCTGT -> TACCCTCTGTC
CTACCCTTAGT -> TACCCTTAGTC
CTACCGCTTGA -> TACCGCTTGAA
CTACCTAGGGT -> TACCTAGGGTA
CTACGCCCGAA -> TACGCCCGAAC
CTACGCTGTGG -> TACGCTGTGGT
CTACTGTGCTC -> TACTGTGCTCA
CTACTTCGGGA -> TACTTCGGGAC
CTAGAATCGTA -> TAGAATCGTAT
CTAGAGACGTC -> TAGAGACGTCG
CTAGCCATGGT -> TAGCCATGGTA
CTAGCTACCTA -> TAGCTACCTAG
CTAGGAAAACG -> TAGGAAAACGC
CTAGGGGAGCC -> TAGGGGAGCCT
CTAGGGTACTC -> TAGGGTACTCA
CTAGGTCTATA -> TAGGTCTATAA
CTAGTATCGCT -> TAGTATCGCTC
CTAGTGGTTTA -> TAGTGGTTTAT
CTATAAGTGGC -> TATAAGTGGCC
CTATAATAGAA -> TATAATAGAAC
CTATAATTCGG -> TATAATTCGGT
CTATAGCTGCA -> TATAGCTGCAT
CTATATGAATT -> TATATGAATTT
CTATCGTCGCC -> TATCGTCGCCT
CTATTAAACTT -> TATTAAACTTA
CTATTTCGCCA -> TATTTCGCCAC
CTCAAGCGAGT -> TCAAGCGAGTT
CTCAAGCGATG -> TCAAGCGATGT
CTCACGGAGTC -> TCACGGAGTCG
CTCATAGGTAT -> TCATAGGTATA
CTCATCCGGTA -> TCATCCGGTAT
CTCATCTTGTG -> TCATCTTGTGT
CTCATGTCCAT -> TCATGTCCATA
CTCCAACAATA -> TCCAACAATAT
CTCCACAACTG -> TCCACAACTGC
CTCCATAACGG -> TCCATAACGGA
CTCCATGAAGA -> TCCATGAAGAG
CTCCATGTTTT -> TCCATGTTTTC
CTCCCAAGCGT -> TCCCAAGCGTA
CTCCCTCTAGG -> TCCCTCTAGGT
CTCCCTTCCGC -> TCCCTTCCGCT
CTCCTCGAGCC -> TCCTCGAGCCC
CTCCTGGGATC -> TCCTGGGATCG
CTCCTTCACTT -> TCCTTCACTTA
CTCGAATGCTA -> TCGAATGCTAT
CTCGACACGTC -> TCGACACGTCG
CTCGAGATCGT -> TCGAGATCGTG
CTCGAGCCCCC -> TCGAGCCCCCC
CTCGATTCAGA -> TCGATTCAGAA
CTCGGGTTACC -> TCGGGTTACCG
CTCGGTGAGCA -> TCGGTGAGCAC
CTCGGTTAATC -> TCGGTTAATCA
CTCGTTAAACT -> TCGTTAAACTC
CTCTAGAATCG -> TCTAGAATCGT
CTCTAGGTCTA -> TCTAGGTCTAT
CTCTATAGCTG -> TCTATAGCTGC
CTCTCCATAAC -> TCTCCATAACG
CTCTCCCTCTA -> TCTCCCTCTAG
CTCTGGACGCT -> TCTGGACGCTA
CTCTGTCGGTC -> TCTGTCGGTCG
CTCTGTGAATG -> TCTGTGAATGT
CTCTTATACTT -> TCTTATACTTC
CTCTTCACACG -> TCTTCACACGT
CTCTTGGAAGT -> TCTTGGAAGTC
CTGATTACGGG -> TGATTACGGGG
CTGCACAAACC -> TGCACAAACCC
CTGCATGGGAT -> TGCATGGGATT
CTGCCATTGAT -> TGCCATTGATT
CTGCCTTCGAC -> TGCCTTCGACC
CTGCGCGGGCG -> TGCGCGGGCGC
CTGCGGCTCGA -> TGCGGCTCGAT
CTGCTAGGGGA -> TGCTAGGGGAG
CTGGACGAAGG -> TGGACGAAGGA
CTGGACGCATC -> TGGACGCATCT
CTGGACGCTAA -> TGGACGCTAAG
CTGGACGGGGA -> TGGACGGGGAT
CTGGCTACCCT -> TGGCTACCCTC
CTGGCTACTGT -> TGGCTACTGTG
CTGGCTGGACG -> TGGCTGGACGG
CTGGGAAGAGT -> TGGGAAGAGTG
CTGGGATCGGT -> TGGGATCGGTT
CTGGGGCAGGT -> TGGGGCAGGTG
CTGTAACTTAT -> TGTAACTTATG
CTGTCGCGTGC -> TGTCGCGTGCC
CTGTCGGTCGA -> TGTCGGTCGAC
CTGTGAATGTA -> TGTGAATGTAT
CTGTGCTCATA -> TGTGCTCATAG
CTGTGGTCCCG -> TGTGGTCCCGG
CTGTGTGAGAT -> TGTGTGAGATG
CTGTTGACATG -> TGTTGACATGA
CTGTTGATATA -> TGTTGATATAT
CTGTTTATTAT -> TGTTTATTATG
CTTAAACCAAG -> TTAAACCAAGC
CTTAAACTGGA -> TTAAACTGGAC
CTTAATTAGGC -> TTAATTAGGCT
CTTACAGGCTC -> TTACAGGCTCG
CTTACTTGGCC -> TTACTTGGCCG
CTTAGAGTGTC -> TTAGAGTGTCC
CTTAGCCGGCG -> TTAGCCGGCGG
CTTAGCTACCC -> TTAGCTACCCT
CTTAGTCGATG -> TTAGTCGATGT
CTTATACTTCG -> TTATACTTCGG
CTTATCAATCC -> TTATCAATCCA
CTTATGATGCT -> TTATGATGCTC
CTTATTTATAT -> TTATTTATATT
CTTCAAGTCTA -> TTCAAGTCTAA
CTTCACACGTT -> TTCACACGTTG
CTTCACTTATT -> TTCACTTATTT
CTTCCACATTA -> TTCCACATTAT
CTTCCGCTCAC -> TTCCGCTCACG
CTTCGACCCAG -> TTCGACCCAGG
CTTCGATTCTT -> TTCGATTCTTT
CTTCGGATCAG -> TTCGGATCAGT
CTTCGGCCAGG -> TTCGGCCAGGT
CTTCGGGACAA -> TTCGGGACAAA
CTTCGTAGTCG -> TTCGTAGTCGA
CTTCGTCAATC -> TTCGTCAATCG
CTTCGTTCGAT -> TTCGTTCGATG
CTTCTTTTTTG -> TTCTTTTTTGG
CTTGAAGTTCA -> TTGAAGTTCAA
CTTGACGTATC -> TTGACGTATCT
CTTGGAAGTCC -> TTGGAAGTCCC
CTTGGCCGGCG -> TTGGCCGGCGA
CTTGTGTGCCG -> TTGTGTGCCGT
CTTTCAGGGGC -> TTTCAGGGGCT
CTTTGCGCACA -> TTTGCGCACAG
CTTTTTTACCA -> TTTTTTACCAG
CTTTTTTGGTC -> TTTTTTGGTCA
GAAAAAAGTAC -> AAAAAAGTACC
GAAAACGCGCA -> AAAACGCGCAA
GAAAGTGCCCG -> AAAGTGCCCGA
GAAATACGCAG -> AAATACGCAGA
GAACCGTATAG -> AACCGTATAGG
GAACCGTCTGT -> AACCGTCTGTA
GAAGAGTAATA -> AAGAGTAATAC
GAAGAGTGGGC -> AAGAGTGGGCG
GAAGCAACGTC -> AAGCAACGTCT
GAAGGAGCTCC -> AAGGAGCTCCC
GAAGGAGTGTT -> AAGGAGTGTTA
GAAGGATCTTG -> AAGGATCTTGA
GAAGGCTACTT -> AAGGCTACTTC
GAAGGTTTATA -> AAGGTTTATAC
GAAGTCCCTAC -> AAGTCCCTACG
GAAGTTCAATG -> AAGTTCAATGG
GAAGTTTCGGC -> AAGTTTCGGCT
GAATCGTATCT -> AATCGTATCTT
GAATGCGCTAT -> AATGCGCTATA
GAATGCTATAA -> AATGCTATAAG
GAATGTATCAT -> AATGTATCATG
GAATGTGCGTG -> AATGTGCGTGG
GAATTGCCCGC -> AATTGCCCGCG
GAATTTATTGG -> AATTTATTGGT
GACAAATCTAT -> ACAAATCTATA
GACAACCTTCG -> ACAACCTTCGT
GACAAGTGTGC -> ACAAGTGTGCC
GACACCGCCTG -> ACACCGCCTGG
GACACGGGGAG -> ACACGGGGAGG
GACACGTCGAA -> ACACGTCGAAG
GACACTTACAG -> ACACTTACAGG
GACACTTCGTT -> ACACTTCGTTC
GACAGACTCGG -> ACAGACTCGGT
GACATCATCTA -> ACATCATCTAG
GACATGACACT -> ACATGACACTT
GACATGCGGGC -> ACATGCGGGCT
GACCAGGGAGC -> ACCAGGGAGCG
GACCATGCGCT -> ACCATGCGCTC
GACCCAGGGAT -> ACCCAGGGATG
GACCCCAGCAC -> ACCCCAGCACA
GACCTAGGAAA -> ACCTAGGAAAA
GACCTATCGTC -> ACCTATCGTCG
GACCTCTAGAA -> ACCTCTAGAAT
GACGAAGGAGC -> ACGAAGGAGCT
GACGACTAGTA -> ACGACTAGTAT
GACGATGTGAG -> ACGATGTGAGA
GACGCATCTAG -> ACGCATCTAGA
GACGCCAATCT -> ACGCCAATCTC
GACGCTAAGGC -> ACGCTAAGGCG
GACGGGGATGT -> ACGGGGATGTG
GACGTAACTGC -> ACGTAACTGCG
GACGTATCTCC -> ACGTATCTCCT
GACGTCGCCTG -> ACGTCGCCTGT
GACTAGTATCG -> ACTAGTATCGC
GACTCGGTTAA -> ACTCGGTTAAT
GACTCTCCATA -> ACTCTCCATAA
GACTCTTCACA -> ACTCTTCACAC
GACTGTGTGAG -> ACTGTGTGAGA
GACTTCGATTC -> ACTTCGATTCT
GACTTTTTTAC -> ACTTTTTTACC
GAGACACGGGG -> AGACACGGGGA
GAGACATCATC -> AGACATCATCT
GAGACGTCGCC -> AGACGTCGCCT
GAGAGAGTTCT -> AGAGAGTTCTT
GAGAGGTTGAC -> AGAGGTTGACA
GAGAGTTCTTT -> AGAGTTCTTTC
GAGATCGTGGG -> AGATCGTGGGA
GAGATGGTGAT -> AGATGGTGATC
GAGCACGCCTC -> AGCACGCCTCG
GAGCCCCCCTC -> AGCCCCCCTCC
GAGCCTCGTTA -> AGCCTCGTTAA
GAGCGGGCTGA -> AGCGGGCTGAT
GAGCGTGTAGG -> AGCGTGTAGGC
GAGCTCCCAAG -> AGCTCCCAAGC
GAGGAAATACG -> AGGAAATACGC
GAGGTGCGGCA -> AGGTGCGGCAC
GAGGTTGACAA -> AGGTTGACAAC
GAGGTTTGGGT -> AGGTTTGGGTT
GAGTAATACTA -> AGTAATACTAC
GAGTCGCATCT -> AGTCGCATCTC
GAGTCGGATCG -> AGTCGGATCGA
GAGTGGGCGTC -> AGTGGGCGTCT
GAGTGTCCTCC -> AGTGTCCTCCT
GAGTGTTATTG -> AGTGTTATTGG
GAGTTCCCAAG -> AGTTCCCAAGT
GAGTTCTCCAT -> AGTTCTCCATG
GAGTTCTTTCA -> AGTTCTTTCAG
GATAACAAGGT -> ATAACAAGGTT
GATACGGACCT -> ATACGGACCTA
GATACGTCAGT -> ATACGTCAGTT
GATACTTCAAG -> ATACTTCAAGT
GATATATGGTT -> ATATATGGTTG
GATCAGTATTG -> ATCAGTATTGC
GATCCATTTGG -> ATCCATTTGGA
GATCGAGTCGG -> ATCGAGTCGGA
GATCGATACGT -> ATCGATACGTC
GATCGGTTCCA -> ATCGGTTCCAC
GATCGTGGGAC -> ATCGTGGGACC
GATCTTAAACT -> ATCTTAAACTG
GATCTTGACGT -> ATCTTGACGTA
GATGCTCATGT -> ATGCTCATGTC
GATGGACTCTT -> ATGGACTCTTC
GATGGTGACCA -> ATGGTGACCAT
GATGGTGATCT -> ATGGTGATCTT
GATGTCTGGGG -> ATGTCTGGGGC
GATGTGAGAGA -> ATGTGAGAGAG
GATGTGCCCAT -> ATGTGCCCATA
GATGTGTTTTA -> ATGTGTTTTAC
GATGTTTCGTC -> ATGTTTCGTCT
GATTAACATGG -> ATTAACATGGA
GATTACGGGGA -> ATTACGGGGAC
GATTCAGAAGT -> ATTCAGAAGTT
GATTCTTTGCG -> ATTCTTTGCGC
GATTGATTAAC -> ATTGATTAACA
GATTGGATAAC -> ATTGGATAACA
GATTGTGGACA -> ATTGTGGACAC
GATTTTGCGAA -> ATTTTGCGAAG
GCAAAAACAAG -> CAAAAACAAGT
GCAACATGATT -> CAACATGATTG
GCAACCCTTAG -> CAACCCTTAGA
GCAACGTCTAA -> CAACGTCTAAC
GCACAAACCCT -> CACAAACCCTA
GCACAAGACGC -> CACAAGACGCC
GCACAGACACT -> CACAGACACTT
GCACCGCTGGC -> CACCGCTGGCT
GCACGAATGTG -> CACGAATGTGC
GCACGCCTCGA -> CACGCCTCGAC
GCACGTGATAC -> CACGTGATACT
GCAGACCTCTA -> CAGACCTCTAG
GCAGGTGTTCG -> CAGGTGTTCGG
GCAGTCAGAGA -> CAGTCAGAGAG
GCAGTCTATTA -> CAGTCTATTAA
GCATAGGACTT -> CATAGGACTTT
GCATCAAGGAT -> CATCAAGGATC
GCATCTAGAGA -> CATCTAGAGAC
GCATCTCAAGC -> CATCTCAAGCG
GCATGGGATTG -> CATGGGATTGT
GCCAAGAATTG -> CCAAGAATTGC
GCCAATCTCAA -> CCAATCTCAAG
GCCACGGTAAG -> CCACGGTAAGC
GCCACTCATCC -> CCACTCATCCG
GCCAGGTCAAC -> CCAGGTCAACT
GCCATGGTACG -> CCATGGTACGT
GCCATTGATTT -> CCATTGATTTT
GCCCAAGCACC -> CCCAAGCACCG
GCCCACCTCTG -> CCCACCTCTGT
GCCCATACAAG -> CCCATACAAGT
GCCCCCCTCCT -> CCCCCCTCCTG
GCCCGAACCGT -> CCCGAACCGTA
GCCCGAAGGCT -> CCCGAAGGCTA
GCCCGCGCGCC -> CCCGCGCGCCT
GCCGGCGATCC -> CCGGCGATCCA
GCCGGCGGGAC -> CCGGCGGGACA
GCCGTTATACC -> CCGTTATACCT
GCCTAGCTACC -> CCTAGCTACCT
GCCTCGACACG -> CCTCGACACGT
GCCTCGTTAAA -> CCTCGTTAAAC
GCCTGCGGCTC -> CCTGCGGCTCG
GCCTGGACGAA -> CCTGGACGAAG
GCCTGTCGCGT -> CCTGTCGCGTG
GCCTGTTTATT -> CCTGTTTATTA
GCCTTAGCTAC -> CCTTAGCTACC
GCCTTCGACCC -> CCTTCGACCCA
GCCTTCGGCCA -> CCTTCGGCCAG
GCCTTCTTTTT -> CCTTCTTTTTT
GCGAAGGATCT -> CGAAGGATCTT
GCGAAGGTTTA -> CGAAGGTTTAT
GCGACATGCGG -> CGACATGCGGG
GCGAGGTTTGG -> CGAGGTTTGGG
GCGAGTTCTCC -> CGAGTTCTCCA
GCGATCCATTT -> CGATCCATTTG
GCGATGTCTGG -> CGATGTCTGGG
GCGCAACATGA -> CGCAACATGAT
GCGCAACCCTT -> CGCAACCCTTA
GCGCACAGACA -> CGCACAGACAC
GCGCCCACCTC -> CGCCCACCTCT
GCGCCTTAGCT -> CGCCTTAGCTA
GCGCGCCTTAG -> CGCGCCTTAGC
GCGCGGCTAGC -> CGCGGCTAGCC
GCGCGGGCGCA -> CGCGGGCGCAA
GCGCTATATGA -> CGCTATATGAA
GCGCTCTGGAC -> CGCTCTGGACG
GCGCTTATCAA -> CGCTTATCAAT
GCGGCACGTGA -> CGGCACGTGAT
GCGGCTAGCCA -> CGGCTAGCCAT
GCGGCTCGATT -> CGGCTCGATTC
GCGGGACAGAC -> CGGGACAGACT
GCGGGCGCAAC -> CGGGCGCAACA
GCGGGCTGATT -> CGGGCTGATTA
GCGGGCTGGGA -> CGGGCTGGGAA
GCGGTATGCAT -> CGGTATGCATA
GCGTAATACTC -> CGTAATACTCG
GCGTCTGGCTG -> CGTCTGGCTGG
GCGTGCCTAGC -> CGTGCCTAGCT
GCGTGGATACG -> CGTGGATACGG
GCGTGTAGGCT -> CGTGTAGGCTT
GCGTGTCCCAC -> CGTGTCCCACG
GCTAACATGCT -> CTAACATGCTA
GCTAAGCCAAG -> CTAAGCCAAGA
GCTAAGGCGCG -> CTAAGGCGCGG
GCTACCCTCTG -> CTACCCTCTGT
GCTACCCTTAG -> CTACCCTTAGT
GCTACCTAGGG -> CTACCTAGGGT
GCTACTGTGCT -> CTACTGTGCTC
GCTACTTCGGG -> CTACTTCGGGA
GCTAGCCATGG -> CTAGCCATGGT
GCTAGGGGAGC -> CTAGGGGAGCC
GCTATAAGTGG -> CTATAAGTGGC
GCTATATGAAT -> CTATATGAATT
GCTCACGGAGT -> CTCACGGAGTC
GCTCATAGGTA -> CTCATAGGTAT
GCTCATGTCCA -> CTCATGTCCAT
GCTCCCAAGCG -> CTCCCAAGCGT
GCTCCCTTCCG -> CTCCCTTCCGC
GCTCGATTCAG -> CTCGATTCAGA
GCTCGGGTTAC -> CTCGGGTTACC
GCTCTATAGCT -> CTCTATAGCTG
GCTCTCCCTCT -> CTCTCCCTCTA
GCTCTGGACGC -> CTCTGGACGCT
GCTCTTGGAAG -> CTCTTGGAAGT
GCTGATTACGG -> CTGATTACGGG
GCTGCATGGGA -> CTGCATGGGAT
GCTGCCATTGA -> CTGCCATTGAT
GCTGCCTTCGA -> CTGCCTTCGAC
GCTGGACGGGG -> CTGGACGGGGA
GCTGGCTACCC -> CTGGCTACCCT
GCTGGCTACTG -> CTGGCTACTGT
GCTGGGAAGAG -> CTGGGAAGAGT
GCTGTGGTCCC -> CTGTGGTCCCG
GCTGTTGACAT -> CTGTTGACATG
GCTTAGCCGGC -> CTTAGCCGGCG
GCTTATCAATC -> CTTATCAATCC
GCTTCGTAGTC -> CTTCGTAGTCG
GCTTCGTCAAT -> CTTCGTCAATC
GCTTGAAGTTC -> CTTGAAGTTCA
GGAAAACGCGC -> GAAAACGCGCA
GGAAAGTGCCC -> GAAAGTGCCCG
GGAAATACGCA -> GAAATACGCAG
GGAAGAGTGGG -> GAAGAGTGGGC
GGAAGTCCCTA -> GAAGTCCCTAC
GGACAAATCTA -> GACAAATCTAT
GGACAAGTGTG -> GACAAGTGTGC
GGACACCGCCT -> GACACCGCCTG
GGACAGACTCG -> GACAGACTCGG
GGACCCCAGCA -> GACCCCAGCAC
GGACCTAGGAA -> GACCTAGGAAA
GGACGAAGGAG -> GACGAAGGAGC
GGACGACTAGT -> GACGACTAGTA
GGACGCATCTA -> GACGCATCTAG
GGACGCTAAGG -> GACGCTAAGGC
GGACGGGGATG -> GACGGGGATGT
GGACGTAACTG -> GACGTAACTGC
GGACTCTTCAC -> GACTCTTCACA
GGACTTTTTTA -> GACTTTTTTAC
GGAGACACGGG -> GAGACACGGGG
GGAGACATCAT -> GAGACATCATC
GGAGCCTCGTT -> GAGCCTCGTTA
GGAGCGTGTAG -> GAGCGTGTAGG
GGAGCTCCCAA -> GAGCTCCCAAG
GGAGGAAATAC -> GAGGAAATACG
GGAGGTGCGGC -> GAGGTGCGGCA
GGAGTCGCATC -> GAGTCGCATCT
GGAGTGTTATT -> GAGTGTTATTG
GGATAACAAGG -> GATAACAAGGT
GGATACGGACC -> GATACGGACCT
GGATCAGTATT -> GATCAGTATTG
GGATCGAGTCG -> GATCGAGTCGG
GGATCGATACG -> GATCGATACGT
GGATCGGTTCC -> GATCGGTTCCA
GGATCTTGACG -> GATCTTGACGT
GGATGGTGACC -> GATGGTGACCA
GGATGTGCCCA -> GATGTGCCCAT
GGATTGATTAA -> GATTGATTAAC
GGATTGTGGAC -> GATTGTGGACA
GGCACGTGATA -> GCACGTGATAC
GGCAGGTGTTC -> GCAGGTGTTCG
GGCCAGGTCAA -> GCCAGGTCAAC
GGCCCAAGCAC -> GCCCAAGCACC
GGCCGGCGATC -> GCCGGCGATCC
GGCCTTCGGCC -> GCCTTCGGCCA
GGCCTTCTTTT -> GCCTTCTTTTT
GGCGAAGGATC -> GCGAAGGATCT
GGCGATCCATT -> GCGATCCATTT
GGCGCAACATG -> GCGCAACATGA
GGCGCCCACCT -> GCGCCCACCTC
GGCGCGGCTAG -> GCGCGGCTAGC
GGCGCTTATCA -> GCGCTTATCAA
GGCGGGACAGA -> GCGGGACAGAC
GGCGTCTGGCT -> GCGTCTGGCTG
GGCTAACATGC -> GCTAACATGCT
GGCTACCCTCT -> GCTACCCTCTG
GGCTACTGTGC -> GCTACTGTGCT
GGCTACTTCGG -> GCTACTTCGGG
GGCTAGCCATG -> GCTAGCCATGG
GGCTCCCTTCC -> GCTCCCTTCCG
GGCTCGATTCA -> GCTCGATTCAG
GGCTCGGGTTA -> GCTCGGGTTAC
GGCTGATTACG -> GCTGATTACGG
GGCTGGACGGG -> GCTGGACGGGG
GGCTGGGAAGA -> GCTGGGAAGAG
GGCTGTTGACA -> GCTGTTGACAT
GGCTTAGCCGG -> GCTTAGCCGGC
GGCTTCGTCAA -> GCTTCGTCAAT
GGGAAGAGTGG -> GGAAGAGTGGG
GGGACAAATCT -> GGACAAATCTA
GGGACAGACTC -> GGACAGACTCG
GGGACCCCAGC -> GGACCCCAGCA
GGGACGACTAG -> GGACGACTAGT
GGGAGCCTCGT -> GGAGCCTCGTT
GGGAGCGTGTA -> GGAGCGTGTAG
GGGAGGAAATA -> GGAGGAAATAC
GGGAGGTGCGG -> GGAGGTGCGGC
GGGATCGGTTC -> GGATCGGTTCC
GGGATGGTGAC -> GGATGGTGACC
GGGATGTGCCC -> GGATGTGCCCA
GGGATTGATTA -> GGATTGATTAA
GGGATTGTGGA -> GGATTGTGGAC
GGGCAGGTGTT -> GGCAGGTGTTC
GGGCGAAGGAT -> GGCGAAGGATC
GGGCGCAACAT -> GGCGCAACATG
GGGCGTCTGGC -> GGCGTCTGGCT
GGGCTAACATG -> GGCTAACATGC
GGGCTGATTAC -> GGCTGATTACG
GGGCTGGGAAG -> GGCTGGGAAGA
GGGGACGACTA -> GGGACGACTAG
GGGGAGCCTCG -> GGGAGCCTCGT
GGGGAGGTGCG -> GGGAGGTGCGG
GGGGATGTGCC -> GGGATGTGCCC
GGGGATTGATT -> GGGATTGATTA
GGGGCAGGTGT -> GGGCAGGTGTT
GGGGCTAACAT -> GGGCTAACATG
GGGGGATTGAT -> GGGGATTGATT
GGGGTATACAC -> GGGTATACACC
GGGTACTCATC -> GGTACTCATCT
GGGTATACACC -> GGTATACACCT
GGGTTACCGAC -> GGTTACCGACT
GGGTTTAAGTA -> GGTTTAAGTAT
GGTAAGCGGTA -> GTAAGCGGTAT
GGTAAGGCGCC -> GTAAGGCGCCC
GGTACGTATGT -> GTACGTATGTA
GGTACTCATCT -> GTACTCATCTT
GGTACTCGGTG -> GTACTCGGTGA
GGTATACACCT -> GTATACACCTT
GGTATACCTCC -> GTATACCTCCA
GGTATGCATAG -> GTATGCATAGG
GGTATTCAGGG -> GTATTCAGGGA
GGTCAACTCTT -> GTCAACTCTTA
GGTCATCGGGC -> GTCATCGGGCG
GGTCATTAGGC -> GTCATTAGGCC
GGTCCACTACG -> GTCCACTACGC
GGTCCCGGACG -> GTCCCGGACGT
GGTCCGACTGT -> GTCCGACTGTG
GGTCGACTTCG -> GTCGACTTCGA
GGTCTATAATT -> GTCTATAATTC
GGTCTGTTGAT -> GTCTGTTGATA
GGTGACCATGC -> GTGACCATGCG
GGTGAGCACGC -> GTGAGCACGCC
GGTGATCTTAA -> GTGATCTTAAA
GGTGCGGCACG -> GTGCGGCACGT
GGTGGGGGATT -> GTGGGGGATTG
GGTGTTCGGTC -> GTGTTCGGTCT
GGTTAATCAGT -> GTTAATCAGTG
GGTTACCGACT -> GTTACCGACTC
GGTTAGGCCTT -> GTTAGGCCTTC
GGTTATGTTCG -> GTTATGTTCGT
GGTTCCACAAT -> GTTCCACAATA
GGTTGACAACC -> GTTGACAACCT
GGTTGTAGCTC -> GTTGTAGCTCT
GGTTTAAGTAT -> GTTTAAGTATC
GGTTTATACCA -> GTTTATACCAC
GGTTTATTGTT -> GTTTATTGTTT
GGTTTGGGTTT -> GTTTGGGTTTA
GTAACTGCGCG -> TAACTGCGCGG
GTAACTTATGA -> TAACTTATGAT
GTAAGCGGTAT -> TAAGCGGTATG
GTAAGGCGCCC -> TAAGGCGCCCA
GTAATACTACC -> TAATACTACCG
GTAATACTCGA -> TAATACTCGAG
GTACAGAAAAA -> TACAGAAAAAA
GTACAGTGAGC -> TACAGTGAGCG
GTACCATTTGC -> TACCATTTGCA
GTACGTATGTA -> TACGTATGTAC
GTACTCATCTT -> TACTCATCTTG
GTACTCGGTGA -> TACTCGGTGAG
GTAGCTCTCCC -> TAGCTCTCCCT
GTAGGCTTCGT -> TAGGCTTCGTC
GTAGTCGAAGC -> TAGTCGAAGCA
GTATACACCTT -> TATACACCTTC
GTATACCTCCA -> TATACCTCCAA
GTATAGGTCCA -> TATAGGTCCAC
GTATCATGGTC -> TATCATGGTCA
GTATCCGCCAC -> TATCCGCCACG
GTATCGCTCTA -> TATCGCTCTAT
GTATCTCCTTC -> TATCTCCTTCA
GTATCTTACTT -> TATCTTACTTG
GTATGCATAGG -> TATGCATAGGA
GTATGTACAGA -> TATGTACAGAA
GTATTCAGGGA -> TATTCAGGGAG
GTATTGCTCTT -> TATTGCTCTTG
GTCAACTCTTA -> TCAACTCTTAT
GTCAATCGACC -> TCAATCGACCT
GTCAGAGAGGT -> TCAGAGAGGTT
GTCAGTTATAG -> TCAGTTATAGC
GTCATCGGGCG -> TCATCGGGCGA
GTCATTAGGCC -> TCATTAGGCCC
GTCATTGCTTC -> TCATTGCTTCG
GTCCACTACGC -> TCCACTACGCT
GTCCATACAAG -> TCCATACAAGG
GTCCCACGGGG -> TCCCACGGGGT
GTCCCGGACGT -> TCCCGGACGTA
GTCCCTACGCC -> TCCCTACGCCC
GTCCGACTGTG -> TCCGACTGTGT
GTCCTCCTCGA -> TCCTCCTCGAG
GTCGAAGCAAC -> TCGAAGCAACG
GTCGAAGGAGT -> TCGAAGGAGTG
GTCGACTTCGA -> TCGACTTCGAT
GTCGATGTTTC -> TCGATGTTTCG
GTCGCATCTCA -> TCGCATCTCAA
GTCGCCTGTCG -> TCGCCTGTCGC
GTCGCCTGTTT -> TCGCCTGTTTA
GTCGCGTGCCT -> TCGCGTGCCTA
GTCGGATCGAT -> TCGGATCGATA
GTCGGTCGACT -> TCGGTCGACTT
GTCTAAAGTGC -> TCTAAAGTGCG
GTCTAACGCTG -> TCTAACGCTGC
GTCTATAATTC -> TCTATAATTCG
GTCTATTAAAC -> TCTATTAAACT
GTCTCCACAAC -> TCTCCACAACT
GTCTGGCTGGA -> TCTGGCTGGAC
GTCTGGGGCAG -> TCTGGGGCAGG
GTCTGTAACTT -> TCTGTAACTTA
GTCTGTTGATA -> TCTGTTGATAT
GTGAATGTATC -> TGAATGTATCA
GTGACCATGCG -> TGACCATGCGC
GTGAGAGAGTT -> TGAGAGAGTTC
GTGAGATGGTG -> TGAGATGGTGA
GTGAGCACGCC -> TGAGCACGCCT
GTGAGCGGGCT -> TGAGCGGGCTG
GTGATACTTCA -> TGATACTTCAA
GTGATCTTAAA -> TGATCTTAAAC
GTGCCCATACA -> TGCCCATACAA
GTGCCCGAAGG -> TGCCCGAAGGC
GTGCCGTTATA -> TGCCGTTATAC
GTGCCTAGCTA -> TGCCTAGCTAC
GTGCCTGCGGC -> TGCCTGCGGCT
GTGCGACATGC -> TGCGACATGCG
GTGCGAGGTTT -> TGCGAGGTTTG
GTGCGGCACGT -> TGCGGCACGTG
GTGCGTGGATA -> TGCGTGGATAC
GTGCTCATAGG -> TGCTCATAGGT
GTGCTGCCTTC -> TGCTGCCTTCG
GTGCTGGCTAC -> TGCTGGCTACC
GTGGACACCGC -> TGGACACCGCC
GTGGATACGGA -> TGGATACGGAC
GTGGCCTTCGG -> TGGCCTTCGGC
GTGGCTCCCTT -> TGGCTCCCTTC
GTGGGACCCCA -> TGGGACCCCAG
GTGGGCGTCTG -> TGGGCGTCTGG
GTGGGGGATTG -> TGGGGGATTGA
GTGGTCCCGGA -> TGGTCCCGGAC
GTGGTTTATTG -> TGGTTTATTGT
GTGTAGGCTTC -> TGTAGGCTTCG
GTGTCATTGCT -> TGTCATTGCTT
GTGTCCCACGG -> TGTCCCACGGG
GTGTCCTCCTC -> TGTCCTCCTCG
GTGTGAGATGG -> TGTGAGATGGT
GTGTGCCGTTA -> TGTGCCGTTAT
GTGTGCCTGCG -> TGTGCCTGCGG
GTGTGCTGGCT -> TGTGCTGGCTA
GTGTTATTGGC -> TGTTATTGGCG
GTGTTCGGTCT -> TGTTCGGTCTG
GTGTTTTACCG -> TGTTTTACCGT
GTTAAACTCCA -> TTAAACTCCAT
GTTAAATATAA -> TTAAATATAAT
GTTAATCAGTG -> TTAATCAGTGT
GTTACCGACTC -> TTACCGACTCT
GTTAGGCCTTC -> TTAGGCCTTCT
GTTATACCTCG -> TTATACCTCGA
GTTATAGCGTG -> TTATAGCGTGT
GTTATGTTCGT -> TTATGTTCGTG
GTTATTGGCGC -> TTATTGGCGCT
GTTCAATGGAA -> TTCAATGGAAA
GTTCCACAATA -> TTCCACAATAA
GTTCCCAAGTT -> TTCCCAAGTTT
GTTCGATGTGT -> TTCGATGTGTT
GTTCGGTCTGT -> TTCGGTCTGTT
GTTCGTGGCTC -> TTCGTGGCTCC
GTTCTCCATGA -> TTCTCCATGAA
GTTCTTTCAGG -> TTCTTTCAGGG
GTTGACAACCT -> TTGACAACCTT
GTTGACATGAC -> TTGACATGACA
GTTGATATATG -> TTGATATATGG
GTTGCAGTCTA -> TTGCAGTCTAT
GTTGTAGCTCT -> TTGTAGCTCTC
GTTGTTGCAGT -> TTGTTGCAGTC
GTTTAAGTATC -> TTTAAGTATCC
GTTTATACCAC -> TTTATACCACG
GTTTATTATGA -> TTTATTATGAA
GTTTATTGTTT -> TTTATTGTTTT
GTTTCACACGT -> TTTCACACGTG
GTTTCATCCTT -> TTTCATCCTTA
GTTTCGGCTTA -> TTTCGGCTTAG
GTTTCGTCTCC -> TTTCGTCTCCA
GTTTGGGTTTA -> TTTGGGTTTAA
GTTTTACCGTT -> TTTTACCGTTT
GTTTTAGTACA -> TTTTAGTACAG
GTTTTCAAGCA -> TTTTCAAGCAA
GTTTTCGTTAA -> TTTTCGTTAAA
TAAACCAAGCA -> AAACCAAGCAG
TAAACTCCATG -> AAACTCCATGT
TAAACTGGACG -> AAACTGGACGC
TAAACTTAATT -> AAACTTAATTA
TAAAGTGCGAC -> AAAGTGCGACA
TAAATATAATT -> AAATATAATTT
TAACAAGGTTA -> AACAAGGTTAG
TAACATGCTAA -> AACATGCTAAG
TAACATGGACA -> AACATGGACAA
TAACCCGAGTT -> AACCCGAGTTC
TAACGCTGCCA -> AACGCTGCCAT
TAACGGAGACA -> AACGGAGACAT
TAACTGCGCGG -> AACTGCGCGGG
TAACTTATGAT -> AACTTATGATG
TAAGCCAAGAA -> AAGCCAAGAAT
TAAGCGGTATG -> AAGCGGTATGC
TAAGGCGCCCA -> AAGGCGCCCAC
TAAGGCGCGGC -> AAGGCGCGGCT
TAAGTATCCGC -> AAGTATCCGCC
TAAGTGGCCTT -> AAGTGGCCTTC
TAAGTTTCACA -> AAGTTTCACAC
TAATACTACCG -> AATACTACCGC
TAATACTCGAG -> AATACTCGAGA
TAATAGAACCG -> AATAGAACCGT
TAATCAGTGTC -> AATCAGTGTCA
TAATTAGGCTG -> AATTAGGCTGT
TAATTCGGTGG -> AATTCGGTGGG
TAATTGACCAG -> AATTGACCAGG
TAATTTAATTG -> AATTTAATTGA
TACAAGGTCCG -> ACAAGGTCCGA
TACAAGTGTGC -> ACAAGTGTGCT
TACACCTTCCA -> ACACCTTCCAC
TACAGAAAAAA -> ACAGAAAAAAG
TACAGGCTCGG -> ACAGGCTCGGG
TACAGTGAGCG -> ACAGTGAGCGG
TACCACGATGG -> ACCACGATGGA
TACCAGGTTAT -> ACCAGGTTATG
TACCATTTGCA -> ACCATTTGCAC
TACCCTCTGTC -> ACCCTCTGTCG
TACCCTTAGTC -> ACCCTTAGTCG
TACCGACTCTC -> ACCGACTCTCC
TACCGCTTGAA -> ACCGCTTGAAG
TACCGTTTCAT -> ACCGTTTCATC
TACCTAGGGTA -> ACCTAGGGTAC
TACCTCCAACA -> ACCTCCAACAA
TACCTCGAATG -> ACCTCGAATGC
TACGCAGACCT -> ACGCAGACCTC
TACGCCCGAAC -> ACGCCCGAACC
TACGCTGTGGT -> ACGCTGTGGTC
TACGGACCTAG -> ACGGACCTAGG
TACGGGGACGA -> ACGGGGACGAC
TACGTATGTAC -> ACGTATGTACA
TACGTCAGTTA -> ACGTCAGTTAT
TACTACCGCTT -> ACTACCGCTTG
TACTCATCTTG -> ACTCATCTTGT
TACTCGAGATC -> ACTCGAGATCG
TACTCGGTGAG -> ACTCGGTGAGC
TACTGTGCTCA -> ACTGTGCTCAT
TACTTCAAGTC -> ACTTCAAGTCT
TACTTCGGATC -> ACTTCGGATCA
TACTTCGGGAC -> ACTTCGGGACA
TACTTGGCCGG -> ACTTGGCCGGC
TAGAACCGTCT -> AGAACCGTCTG
TAGAATCGTAT -> AGAATCGTATC
TAGAGACGTCG -> AGAGACGTCGC
TAGAGTGTCCT -> AGAGTGTCCTC
TAGCCATGGTA -> AGCCATGGTAC
TAGCCGGCGGG -> AGCCGGCGGGA
TAGCGTGTCCC -> AGCGTGTCCCA
TAGCTACCCTT -> AGCTACCCTTA
TAGCTACCTAG -> AGCTACCTAGG
TAGCTCTCCCT -> AGCTCTCCCTC
TAGCTGCATGG -> AGCTGCATGGG
TAGGAAAACGC -> AGGAAAACGCG
TAGGACTTTTT -> AGGACTTTTTT
TAGGCCCAAGC -> AGGCCCAAGCA
TAGGCCTTCTT -> AGGCCTTCTTT
TAGGCTGTTGA -> AGGCTGTTGAC
TAGGCTTCGTC -> AGGCTTCGTCA
TAGGGGAGCCT -> AGGGGAGCCTC
TAGGGTACTCA -> AGGGTACTCAT
TAGGTACTCGG -> AGGTACTCGGT
TAGGTATACCT -> AGGTATACCTC
TAGGTCCACTA -> AGGTCCACTAC
TAGGTCTATAA -> AGGTCTATAAT
TAGTACAGTGA -> AGTACAGTGAG
TAGTATCGCTC -> AGTATCGCTCT
TAGTCGAAGCA -> AGTCGAAGCAA
TAGTCGATGTT -> AGTCGATGTTT
TAGTGGTTTAT -> AGTGGTTTATT
TATAAGTGGCC -> ATAAGTGGCCT
TATAAGTTTCA -> ATAAGTTTCAC
TATAATAGAAC -> ATAATAGAACC
TATAATTCGGT -> ATAATTCGGTG
TATAATTTAAT -> ATAATTTAATT
TATACACCTTC -> ATACACCTTCC
TATACCACGAT -> ATACCACGATG
TATACCTCCAA -> ATACCTCCAAC
TATACCTCGAA -> ATACCTCGAAT
TATACTTCGGA -> ATACTTCGGAT
TATAGCGTGTC -> ATAGCGTGTCC
TATAGCTGCAT -> ATAGCTGCATG
TATAGGTCCAC -> ATAGGTCCACT
TATATGAATTT -> ATATGAATTTA
TATATGGTTGT -> ATATGGTTGTA
TATATTAGGTA -> ATATTAGGTAC
TATCAATCCAC -> ATCAATCCACG
TATCATGGTCA -> ATCATGGTCAT
TATCCGCCACG -> ATCCGCCACGG
TATCGCTCTAT -> ATCGCTCTATA
TATCGTCGCCT -> ATCGTCGCCTG
TATCTCCTTCA -> ATCTCCTTCAC
TATCTGCACAA -> ATCTGCACAAA
TATCTTACTTG -> ATCTTACTTGG
TATGAATGCGC -> ATGAATGCGCT
TATGAATTTAT -> ATGAATTTATT
TATGATGCTCA -> ATGATGCTCAT
TATGCATAGGA -> ATGCATAGGAC
TATGGTTGTAG -> ATGGTTGTAGC
TATGTACAGAA -> ATGTACAGAAA
TATGTTCGTGG -> ATGTTCGTGGC
TATTAAACTTA -> ATTAAACTTAA
TATTAGGTACT -> ATTAGGTACTC
TATTATGAATG -> ATTATGAATGC
TATTCAGGGAG -> ATTCAGGGAGG
TATTGCTCTTG -> ATTGCTCTTGG
TATTGGCGCTT -> ATTGGCGCTTA
TATTGGTAAGG -> ATTGGTAAGGC
TATTGTTTTCA -> ATTGTTTTCAA
TATTTATATTA -> ATTTATATTAG
TATTTCGCCAC -> ATTTCGCCACT
TCAACTCTTAT -> CAACTCTTATA
TCAAGCAAAAA -> CAAGCAAAAAC
TCAAGCGAGTT -> CAAGCGAGTTC
TCAAGCGATGT -> CAAGCGATGTC
TCAAGGATCGA -> CAAGGATCGAG
TCAAGTCTAAA -> CAAGTCTAAAG
TCAATCCACGC -> CAATCCACGCA
TCAATCGACCT -> CAATCGACCTA
TCAATGGAAAG -> CAATGGAAAGT
TCACACGTGCG -> CACACGTGCGA
TCACACGTTGT -> CACACGTTGTT
TCACGGAGTCG -> CACGGAGTCGC
TCACTTATTTA -> CACTTATTTAT
TCAGAAGTTTC -> CAGAAGTTTCG
TCAGAGAGGTT -> CAGAGAGGTTG
TCAGGGAGGAA -> CAGGGAGGAAA
TCAGGGGCTAA -> CAGGGGCTAAC
TCAGTATTGCT -> CAGTATTGCTC
TCAGTGTCATT -> CAGTGTCATTG
TCAGTTATAGC -> CAGTTATAGCG
TCATAGGTATA -> CATAGGTATAC
TCATCCGGTAT -> CATCCGGTATT
TCATCCTTAAA -> CATCCTTAAAC
TCATCGGGCGA -> CATCGGGCGAA
TCATCTAGTGG -> CATCTAGTGGT
TCATCTTGTGT -> CATCTTGTGTG
TCATGGTCATC -> CATGGTCATCG
TCATGTCCATA -> CATGTCCATAC
TCATTAGGCCC -> CATTAGGCCCA
TCATTGCTTCG -> CATTGCTTCGT
TCCAACAATAT -> CCAACAATATC
TCCACAACTGC -> CCACAACTGCT
TCCACAATAAC -> CCACAATAACC
TCCACATTATA -> CCACATTATAA
TCCACGCATCA -> CCACGCATCAA
TCCACTACGCT -> CCACTACGCTG
TCCATAACGGA -> CCATAACGGAG
TCCATACAAGG -> CCATACAAGGT
TCCATGAAGAG -> CCATGAAGAGT
TCCATGTTTTC -> CCATGTTTTCG
TCCATTTGGAG -> CCATTTGGAGA
TCCCAAGCGTA -> CCCAAGCGTAA
TCCCAAGTTTT -> CCCAAGTTTTA
TCCCACGGGGT -> CCCACGGGGTA
TCCCGGACGTA -> CCCGGACGTAA
TCCCTACGCCC -> CCCTACGCCCG
TCCCTCTAGGT -> CCCTCTAGGTC
TCCCTTCCGCT -> CCCTTCCGCTC
TCCGACTGTGT -> CCGACTGTGTG
TCCGCCACGGT -> CCGCCACGGTA
TCCGCTCACGG -> CCGCTCACGGA
TCCGGTATTCA -> CCGGTATTCAG
TCCTCCTCGAG -> CCTCCTCGAGC
TCCTCGAGCCC -> CCTCGAGCCCC
TCCTGGGATCG -> CCTGGGATCGG
TCCTTAAACCA -> CCTTAAACCAA
TCCTTCACTTA -> CCTTCACTTAT
TCGAAGCAACG -> CGAAGCAACGT
TCGAAGGAGTG -> CGAAGGAGTGT
TCGAATGCTAT -> CGAATGCTATA
TCGACACGTCG -> CGACACGTCGA
TCGACCCAGGG -> CGACCCAGGGA
TCGACCTATCG -> CGACCTATCGT
TCGACTTCGAT -> CGACTTCGATT
TCGAGATCGTG -> CGAGATCGTGG
TCGAGCCCCCC -> CGAGCCCCCCT
TCGAGTCGGAT -> CGAGTCGGATC
TCGATACGTCA -> CGATACGTCAG
TCGATGTGTTT -> CGATGTGTTTT
TCGATGTTTCG -> CGATGTTTCGT
TCGATTCAGAA -> CGATTCAGAAG
TCGATTCTTTG -> CGATTCTTTGC
TCGCATCTCAA -> CGCATCTCAAG
TCGCCACTCAT -> CGCCACTCATC
TCGCCTGTCGC -> CGCCTGTCGCG
TCGCCTGTTTA -> CGCCTGTTTAT
TCGCGTGCCTA -> CGCGTGCCTAG
TCGCTCTATAG -> CGCTCTATAGC
TCGGATCAGTA -> CGGATCAGTAT
TCGGATCGATA -> CGGATCGATAC
TCGGCCAGGTC -> CGGCCAGGTCA
TCGGCTTAGCC -> CGGCTTAGCCG
TCGGGACAAAT -> CGGGACAAATC
TCGGGCGAAGG -> CGGGCGAAGGA
TCGGGTTACCG -> CGGGTTACCGA
TCGGTCGACTT -> CGGTCGACTTC
TCGGTCTGTTG -> CGGTCTGTTGA
TCGGTGAGCAC -> CGGTGAGCACG
TCGGTGGGGGA -> CGGTGGGGGAT
TCGGTTAATCA -> CGGTTAATCAG
TCGGTTCCACA -> CGGTTCCACAA
TCGTAGTCGAA -> CGTAGTCGAAG
TCGTATCTTAC -> CGTATCTTACT
TCGTCAATCGA -> CGTCAATCGAC
TCGTCGCCTGT -> CGTCGCCTGTT
TCGTCTCCACA -> CGTCTCCACAA
TCGTGGCTCCC -> CGTGGCTCCCT
TCGTGGGACCC -> CGTGGGACCCC
TCGTTAAACTC -> CGTTAAACTCC
TCGTTAAATAT -> CGTTAAATATA
TCGTTCGATGT -> CGTTCGATGTG
TCTAAAGTGCG -> CTAAAGTGCGA
TCTAACGCTGC -> CTAACGCTGCC
TCTAGAATCGT -> CTAGAATCGTA
TCTAGAGACGT -> CTAGAGACGTC
TCTAGGTCTAT -> CTAGGTCTATA
TCTAGTGGTTT -> CTAGTGGTTTA
TCTATAATAGA -> CTATAATAGAA
TCTATAATTCG -> CTATAATTCGG
TCTATAGCTGC -> CTATAGCTGCA
TCTATTAAACT -> CTATTAAACTT
TCTCAAGCGAG -> CTCAAGCGAGT
TCTCAAGCGAT -> CTCAAGCGATG
TCTCCACAACT -> CTCCACAACTG
TCTCCATAACG -> CTCCATAACGG
TCTCCATGAAG -> CTCCATGAAGA
TCTCCCTCTAG -> CTCCCTCTAGG
TCTCCTTCACT -> CTCCTTCACTT
TCTGCACAAAC -> CTGCACAAACC
TCTGGACGCTA -> CTGGACGCTAA
TCTGGCTGGAC -> CTGGCTGGACG
TCTGGGGCAGG -> CTGGGGCAGGT
TCTGTAACTTA -> CTGTAACTTAT
TCTGTCGGTCG -> CTGTCGGTCGA
TCTGTGAATGT -> CTGTGAATGTA
TCTGTTGATAT -> CTGTTGATATA
TCTTAAACTGG -> CTTAAACTGGA
TCTTACTTGGC -> CTTACTTGGCC
TCTTATACTTC -> CTTATACTTCG
TCTTCACACGT -> CTTCACACGTT
TCTTGACGTAT -> CTTGACGTATC
TCTTGGAAGTC -> CTTGGAAGTCC
TCTTGTGTGCC -> CTTGTGTGCCG
TCTTTCAGGGG -> CTTTCAGGGGC
TCTTTGCGCAC -> CTTTGCGCACA
TCTTTTTTGGT -> CTTTTTTGGTC
TGAAGAGTAAT -> GAAGAGTAATA
TGAAGTTCAAT -> GAAGTTCAATG
TGAATGCGCTA -> GAATGCGCTAT
TGAATGTATCA -> GAATGTATCAT
TGAATTTATTG -> GAATTTATTGG
TGACAACCTTC -> GACAACCTTCG
TGACACTTCGT -> GACACTTCGTT
TGACATGACAC -> GACATGACACT
TGACCAGGGAG -> GACCAGGGAGC
TGACCATGCGC -> GACCATGCGCT
TGACGATGTGA -> GACGATGTGAG
TGACGTATCTC -> GACGTATCTCC
TGAGAGAGTTC -> GAGAGAGTTCT
TGAGATGGTGA -> GAGATGGTGAT
TGAGCACGCCT -> GAGCACGCCTC
TGAGCGGGCTG -> GAGCGGGCTGA
TGATACTTCAA -> GATACTTCAAG
TGATATATGGT -> GATATATGGTT
TGATCTTAAAC -> GATCTTAAACT
TGATGCTCATG -> GATGCTCATGT
TGATTAACATG -> GATTAACATGG
TGATTACGGGG -> GATTACGGGGA
TGATTGGATAA -> GATTGGATAAC
TGATTTTGCGA -> GATTTTGCGAA
TGCACAAACCC -> GCACAAACCCT
TGCACGAATGT -> GCACGAATGTG
TGCAGTCTATT -> GCAGTCTATTA
TGCATAGGACT -> GCATAGGACTT
TGCATGGGATT -> GCATGGGATTG
TGCCATTGATT -> GCCATTGATTT
TGCCCATACAA -> GCCCATACAAG
TGCCCGAAGGC -> GCCCGAAGGCT
TGCCCGCGCGC -> GCCCGCGCGCC
TGCCGTTATAC -> GCCGTTATACC
TGCCTAGCTAC -> GCCTAGCTACC
TGCCTGCGGCT -> GCCTGCGGCTC
TGCCTTCGACC -> GCCTTCGACCC
TGCGAAGGTTT -> GCGAAGGTTTA
TGCGACATGCG -> GCGACATGCGG
TGCGAGGTTTG -> GCGAGGTTTGG
TGCGCACAGAC -> GCGCACAGACA
TGCGCGGGCGC -> GCGCGGGCGCA
TGCGCTATATG -> GCGCTATATGA
TGCGCTCTGGA -> GCGCTCTGGAC
TGCGGCACGTG -> GCGGCACGTGA
TGCGGCTCGAT -> GCGGCTCGATT
TGCGGGCTGGG -> GCGGGCTGGGA
TGCGTGGATAC -> GCGTGGATACG
TGCTAAGCCAA -> GCTAAGCCAAG
TGCTAGGGGAG -> GCTAGGGGAGC
TGCTATAAGTG -> GCTATAAGTGG
TGCTCATAGGT -> GCTCATAGGTA
TGCTCATGTCC -> GCTCATGTCCA
TGCTCTTGGAA -> GCTCTTGGAAG
TGCTGCCTTCG -> GCTGCCTTCGA
TGCTGGCTACC -> GCTGGCTACCC
TGCTTCGTAGT -> GCTTCGTAGTC
TGGAAAGTGCC -> GGAAAGTGCCC
TGGAAGTCCCT -> GGAAGTCCCTA
TGGACAAGTGT -> GGACAAGTGTG
TGGACACCGCC -> GGACACCGCCT
TGGACGAAGGA -> GGACGAAGGAG
TGGACGCATCT -> GGACGCATCTA
TGGACGCTAAG -> GGACGCTAAGG
TGGACGGGGAT -> GGACGGGGATG
TGGACTCTTCA -> GGACTCTTCAC
TGGAGACACGG -> GGAGACACGGG
TGGATAACAAG -> GGATAACAAGG
TGGATACGGAC -> GGATACGGACC
TGGCCGGCGAT -> GGCCGGCGATC
TGGCCTTCGGC -> GGCCTTCGGCC
TGGCGCTTATC -> GGCGCTTATCA
TGGCTACCCTC -> GGCTACCCTCT
TGGCTACTGTG -> GGCTACTGTGC
TGGCTCCCTTC -> GGCTCCCTTCC
TGGCTGGACGG -> GGCTGGACGGG
TGGGAAGAGTG -> GGGAAGAGTGG
TGGGACCCCAG -> GGGACCCCAGC
TGGGATCGGTT -> GGGATCGGTTC
TGGGATTGTGG -> GGGATTGTGGA
TGGGCGTCTGG -> GGGCGTCTGGC
TGGGGCAGGTG -> GGGGCAGGTGT
TGGGGGATTGA -> GGGGGATTGAT
TGGGTTTAAGT -> GGGTTTAAGTA
TGGTAAGGCGC -> GGTAAGGCGCC
TGGTACGTATG -> GGTACGTATGT
TGGTCATCGGG -> GGTCATCGGGC
TGGTCATTAGG -> GGTCATTAGGC
TGGTCCCGGAC -> GGTCCCGGACG
TGGTGACCATG -> GGTGACCATGC
TGGTGATCTTA -> GGTGATCTTAA
TGGTTGTAGCT -> GGTTGTAGCTC
TGGTTTATTGT -> GGTTTATTGTT
TGTAACTTATG -> GTAACTTATGA
TGTACAGAAAA -> GTACAGAAAAA
TGTAGCTCTCC -> GTAGCTCTCCC
TGTAGGCTTCG -> GTAGGCTTCGT
TGTATCATGGT -> GTATCATGGTC
TGTCATTGCTT -> GTCATTGCTTC
TGTCCATACAA -> GTCCATACAAG
TGTCCCACGGG -> GTCCCACGGGG
TGTCCTCCTCG -> GTCCTCCTCGA
TGTCGCGTGCC -> GTCGCGTGCCT
TGTCGGTCGAC -> GTCGGTCGACT
TGTCTGGGGCA -> GTCTGGGGCAG
TGTGAATGTAT -> GTGAATGTATC
TGTGAGAGAGT -> GTGAGAGAGTT
TGTGAGATGGT -> GTGAGATGGTG
TGTGCCCATAC -> GTGCCCATACA
TGTGCCGTTAT -> GTGCCGTTATA
TGTGCCTGCGG -> GTGCCTGCGGC
TGTGCGTGGAT -> GTGCGTGGATA
TGTGCTCATAG -> GTGCTCATAGG
TGTGCTGGCTA -> GTGCTGGCTAC
TGTGGACACCG -> GTGGACACCGC
TGTGGTCCCGG -> GTGGTCCCGGA
TGTGTGAGATG -> GTGTGAGATGG
TGTGTGCCGTT -> GTGTGCCGTTA
TGTGTTTTACC -> GTGTTTTACCG
TGTTATTGGCG -> GTTATTGGCGC
TGTTCGGTCTG -> GTTCGGTCTGT
TGTTCGTGGCT -> GTTCGTGGCTC
TGTTGACATGA -> GTTGACATGAC
TGTTGATATAT -> GTTGATATATG
TGTTGCAGTCT -> GTTGCAGTCTA
TGTTTATTATG -> GTTTATTATGA
TGTTTCGTCTC -> GTTTCGTCTCC
TGTTTTACCGT -> GTTTTACCGTT
TGTTTTCAAGC -> GTTTTCAAGCA
TGTTTTCGTTA -> GTTTTCGTTAA
TTAAACCAAGC -> TAAACCAAGCA
TTAAACTCCAT -> TAAACTCCATG
TTAAACTGGAC -> TAAACTGGACG
TTAAACTTAAT -> TAAACTTAATT
TTAAATATAAT -> TAAATATAATT
TTAACATGGAC -> TAACATGGACA
TTAAGTATCCG -> TAAGTATCCGC
TTAATCAGTGT -> TAATCAGTGTC
TTAATTAGGCT -> TAATTAGGCTG
TTAATTGACCA -> TAATTGACCAG
TTACAGGCTCG -> TACAGGCTCGG
TTACCAGGTTA -> TACCAGGTTAT
TTACCGACTCT -> TACCGACTCTC
TTACCGTTTCA -> TACCGTTTCAT
TTACGGGGACG -> TACGGGGACGA
TTACTTGGCCG -> TACTTGGCCGG
TTAGAGTGTCC -> TAGAGTGTCCT
TTAGCCGGCGG -> TAGCCGGCGGG
TTAGCTACCCT -> TAGCTACCCTT
TTAGGCCCAAG -> TAGGCCCAAGC
TTAGGCCTTCT -> TAGGCCTTCTT
TTAGGCTGTTG -> TAGGCTGTTGA
TTAGGTACTCG -> TAGGTACTCGG
TTAGTACAGTG -> TAGTACAGTGA
TTAGTCGATGT -> TAGTCGATGTT
TTATAAGTTTC -> TATAAGTTTCA
TTATACCACGA -> TATACCACGAT
TTATACCTCGA -> TATACCTCGAA
TTATACTTCGG -> TATACTTCGGA
TTATAGCGTGT -> TATAGCGTGTC
TTATATTAGGT -> TATATTAGGTA
TTATCAATCCA -> TATCAATCCAC
TTATGAATGCG -> TATGAATGCGC
TTATGATGCTC -> TATGATGCTCA
TTATGTTCGTG -> TATGTTCGTGG
TTATTATGAAT -> TATTATGAATG
TTATTGGCGCT -> TATTGGCGCTT
TTATTGGTAAG -> TATTGGTAAGG
TTATTGTTTTC -> TATTGTTTTCA
TTATTTATATT -> TATTTATATTA
TTCAAGCAAAA -> TCAAGCAAAAA
TTCAAGTCTAA -> TCAAGTCTAAA
TTCAATGGAAA -> TCAATGGAAAG
TTCACACGTGC -> TCACACGTGCG
TTCACACGTTG -> TCACACGTTGT
TTCACTTATTT -> TCACTTATTTA
TTCAGAAGTTT -> TCAGAAGTTTC
TTCAGGGAGGA -> TCAGGGAGGAA
TTCAGGGGCTA -> TCAGGGGCTAA
TTCATCCTTAA -> TCATCCTTAAA
TTCCACAATAA -> TCCACAATAAC
TTCCACATTAT -> TCCACATTATA
TTCCCAAGTTT -> TCCCAAGTTTT
TTCCGCTCACG -> TCCGCTCACGG
TTCGACCCAGG -> TCGACCCAGGG
TTCGATGTGTT -> TCGATGTGTTT
TTCGATTCTTT -> TCGATTCTTTG
TTCGCCACTCA -> TCGCCACTCAT
TTCGGATCAGT -> TCGGATCAGTA
TTCGGCCAGGT -> TCGGCCAGGTC
TTCGGCTTAGC -> TCGGCTTAGCC
TTCGGGACAAA -> TCGGGACAAAT
TTCGGTCTGTT -> TCGGTCTGTTG
TTCGGTGGGGG -> TCGGTGGGGGA
TTCGTAGTCGA -> TCGTAGTCGAA
TTCGTCAATCG -> TCGTCAATCGA
TTCGTCTCCAC -> TCGTCTCCACA
TTCGTGGCTCC -> TCGTGGCTCCC
TTCGTTAAATA -> TCGTTAAATAT
TTCGTTCGATG -> TCGTTCGATGT
TTCTCCATGAA -> TCTCCATGAAG
TTCTTTCAGGG -> TCTTTCAGGGG
TTCTTTGCGCA -> TCTTTGCGCAC
TTCTTTTTTGG -> TCTTTTTTGGT
TTGAAGTTCAA -> TGAAGTTCAAT
TTGACAACCTT -> TGACAACCTTC
TTGACATGACA -> TGACATGACAC
TTGACCAGGGA -> TGACCAGGGAG
TTGACGTATCT -> TGACGTATCTC
TTGATATATGG -> TGATATATGGT
TTGATTAACAT -> TGATTAACATG
TTGATTTTGCG -> TGATTTTGCGA
TTGCACGAATG -> TGCACGAATGT
TTGCAGTCTAT -> TGCAGTCTATT
TTGCCCGCGCG -> TGCCCGCGCGC
TTGCGAAGGTT -> TGCGAAGGTTT
TTGCGCACAGA -> TGCGCACAGAC
TTGCTCTTGGA -> TGCTCTTGGAA
TTGCTTCGTAG -> TGCTTCGTAGT
TTGGAAGTCCC -> TGGAAGTCCCT
TTGGAGACACG -> TGGAGACACGG
TTGGATAACAA -> TGGATAACAAG
TTGGCCGGCGA -> TGGCCGGCGAT
TTGGCGCTTAT -> TGGCGCTTATC
TTGGGTTTAAG -> TGGGTTTAAGT
TTGGTAAGGCG -> TGGTAAGGCGC
TTGGTCATTAG -> TGGTCATTAGG
TTGTAGCTCTC -> TGTAGCTCTCC
TTGTGGACACC -> TGTGGACACCG
TTGTGTGCCGT -> TGTGTGCCGTT
TTGTTGCAGTC -> TGTTGCAGTCT
TTGTTTTCAAG -> TGTTTTCAAGC
TTTAAGTATCC -> TTAAGTATCCG
TTTAATTGACC -> TTAATTGACCA
TTTACCAGGTT -> TTACCAGGTTA
TTTACCGTTTC -> TTACCGTTTCA
TTTAGTACAGT -> TTAGTACAGTG
TTTATACCACG -> TTATACCACGA
TTTATATTAGG -> TTATATTAGGT
TTTATTATGAA -> TTATTATGAAT
TTTATTGGTAA -> TTATTGGTAAG
TTTATTGTTTT -> TTATTGTTTTC
TTTCAAGCAAA -> TTCAAGCAAAA
TTTCACACGTG -> TTCACACGTGC
TTTCAGGGGCT -> TTCAGGGGCTA
TTTCATCCTTA -> TTCATCCTTAA
TTTCGCCACTC -> TTCGCCACTCA
TTTCGGCTTAG -> TTCGGCTTAGC
TTTCGTCTCCA -> TTCGTCTCCAC
TTTCGTTAAAT -> TTCGTTAAATA
TTTGCACGAAT -> TTGCACGAATG
TTTGCGAAGGT -> TTGCGAAGGTT
TTTGCGCACAG -> TTGCGCACAGA
TTTGGAGACAC -> TTGGAGACACG
TTTGGGTTTAA -> TTGGGTTTAAG
TTTGGTCATTA -> TTGGTCATTAG
TTTTACCAGGT -> TTTACCAGGTT
TTTTACCGTTT -> TTTACCGTTTC
TTTTAGTACAG -> TTTAGTACAGT
TTTTCAAGCAA -> TTTCAAGCAAA
TTTTCGTTAAA -> TTTCGTTAAAT
TTTTGCGAAGG -> TTTGCGAAGGT
TTTTGGTCATT -> TTTGGTCATTA
TTTTTACCAGG -> TTTTACCAGGT
TTTTTGGTCAT -> TTTTGGTCATT
TTTTTTACCAG -> TTTTTACCAGG
TTTTTTGGTCA -> TTTTTGGTCAT
