30 100
CGTTCTCGGATCAACGCGGTGCGTCCGTTT|GAACGGGTAGTAGGTGTGATAGTTTCCACC
TGATAGTTTCCACCTAGCCACAGCTTCCTG|CGTGGCTTGGTCACTGCTCGGCACGTCGGC
ACTTTGAACGCGACCCGTATGGTGGTACGA|CACGTCGGCAGGGTTGCCCGAAAGGGCGCT
GGGCGCTATCGAGTTTGGGCACGTCGGCAG|TAACTCATTAGTAGTCCAATTATAAGCCAC
TCAGTTCACATGCTAGCCAAATTATCATGG|GTTGCCCGAAAGGGCGGGGCGCTATCGAGT
GACTTTGAACGCGACCCGTATGGTGGTACG|GCACGTCGGCAGGGTTGCCCGAAAGGGCGC
CATGCAGCGATACTTACAAGGTTCCGAACA|CAGGGTTGCCCGAAAGGGCGCCCGAAAGGG
AGAGGCACGTCGGCAGGGTTGCCCGAAAGG|ACAGCCATGCAGCGATACTTACAAGGTTCC
CACGATATACGGAACCCTGCGCGGCCGGCC|TTGCCCGAAAGGGCGTCGGTTTAATGCTGC
GGTTGCCCGAAAGGGCGGGACAGGGACTGC|CGGCCGGCCGCCGATGGACGGAGAATGTGA
ACTCAGCTTGTGAGGTGGTATAGACTAGCA|CCAGAGTGGCCTTTTACAGCTCCGCAACGC
CTTAACCGAAGGCTGTTACCTGACTGAAAA|GGCGCATTGAATAGGGCCTGTAGCGACTAT
CGTCGGCAGGGTTGCCCGAAAGGGCGGGAC|AACCCTGCGCGGCCGGCCGCCGATGGACGG
TACGATTGTTATCGCACCAGAGTGGCCTTT|GCGCTAATCCGGTCGGACAATCTCTGTAGT
ATTAGACTCAGCTTGTGAGGTGGTATAGAC|TCGCACCAGAGTGGCCTTTTACAGCTCCGC
CGCAACGCCATAACTCGGTCGGTTAGAAAA|AGACACTTGAACCTTGCTGAGGGAATGTTT
GCGTCCGTTTCGTTTAACGGGTTTCGGGAG|AGTTTCCACCTAGCCACAGCTTCCTGATCC
CCACTCCACCCTATGCGATTGATGGCACGT|GCCTGTTGGCACGTCGGCAGGGTTGCCCGA
GTTGCCCGAAAGGGCGGGGCGCTATCGAGT|ACTCCGGCGAAGCTTATAACTCATTAGTAG
TTGCCCGAAAGGGCGCATTGAATAGGGCCT|AGCTTATTGTACAGTTTTTCGTAGCAGGTG
GCTTATAACTCATTAGTAGTCCAATTATAA|CAGCTAAAGCTTGCCGTATATACTTTGGCG
CCATGCAGCGATACTTACAAGGTTCCGAAC|GCAGGGTTGCCCGAAAGGGCGCCCGAAAGG
CACGTCGGCAGGGTTGCCCGAAAGGGCGGG|GGAACCCTGCGCGGCCGGCCGCCGATGGAC
CGTCGGCCACGATATACGGAACCCTGCGCG|GGCAGGGTTGCCCGAAAGGGCGTCGGTTTA
ATACAGCCCAAACAGCCATGCAGCGATACT|GGGTTGGGCACGTCGGCAGGGTTGCCCGAA
CGTTTCGTTTAACGGGTTTCGGGAGGGAGG|CCACCTAGCCACAGCTTCCTGATCCCCCAT
AGTGGGCACGTCGGCAGGGTTGCCCGAAAG|TTCGTTTAACGGGTTTCGGGAGGGAGGCAC
CACGTCGGCAGGGTTGCCCGAAAGGGCGGG|GAACACGCAACAACTCCGGCGAAGCTTATA
CTGAGGGAATGTTTGCACGTTCTCGGATCA|TTCCGGACTGCCTATGAGAACGGGTAGTAG
CAGGGTTGCCCGAAAGGGCGGCATCGTTTT|GTCGGCAGGGTTGCCCGAAAGGGCGAGTGG
TTGCCCGAAAGGGCGGACTACAAATCCCGT|GAACGCGACCCGTATGGTGGTACGATTGTT
TAAAGCTTGCCGTATATACTTTGGCGGGCC|TAAGGCACGTCGGCAGGGTTGCCCGAAAGG
TCCGGCGAAGCTTATAACTCATTAGTAGTC|GTTGCAAGTCAGCTAAAGCTTGCCGTATAT
GGTAGTAGGTGTGATAGTTTCCACCTAGCC|ACTGAAAATATCGTGGCTTGGTCACTGCTC
GCGACTATTCCCTCCCGTCGGCCACGATAT|AAAAGTCGGCACGTCGGCAGGGTTGCCCGA
ATGGCACGTCGGCAGGGTTGGGCACGTCGG|GTTGCCCGAAAGGGCGGACTACAAATCCCG
GAATGACGAGAATCCTTTCCGGACTGCCTA|CTCCACGAACCTCGTCCTTAACCGAAGGCT
GGTTGCCCGAAAGGGCGAAAAGGCCAAGAG|GTGGGCAGCCGTAAAATACAGCCCAAACAG
CCCTATGCGATTGATGGCACGTCGGCAGGG|GCACGTCGGCAGGGTTGCCCGAAAGGGCGG
TAGTCTTTTCATAGACACTTGAACCTTGCT|ATGTCACTGGGCGAATGACGAGAATCCTTT
TCATTAGTAGTCCAATTATAAGCCACTCCA|CTTGCCGTATATACTTTGGCGGGCCTGTTG
GGTTGCCCGAAAGGGCGTGACTCTCTTATT|GTCGGCAGGGTTGCCCGAAAGGCACGTCGG
GCACGTCGGCAGGGTTGCCCGAAAGGGCGC|TTAACGGGTTTCGGGAGGGAGGCACGTCGG
CGTTTAACGGGTTTCGGGAGGGAGGCACGT|TAGCCACAGCTTCCTGATCCCCCATGTCGG
CGGATCAACGCGGTGCGTCCGTTTCGTTTA|GTAGTAGGTGTGATAGTTTCCACCTAGCCA
TATCGCACCAGAGTGGCCTTTTACAGCTCC|CGGTCGGACAATCTCTGTAGTCTTTTCATA
GCAGGGTTGCCCGAAAGGGCGTGGGCAGCC|CCACTCCACCCTATGCGATTGATGGCACGT
GCGGGACAGGGACTGCAAACTCCTAGGCAC|TGGACGGAGAATGTGATGAATAGCTCAGGT
CTTGAACCTTGCTGAGGGAATGTTTGCACG|ACGAGAATCCTTTCCGGACTGCCTATGAGA
CAAACTCCTAGGCACGTCGGCAGGGTTGCC|ATGAATAGCTCAGGTGATCATCAGGAGCTT
GCGGCATCGTTTTGACTTTGAACGCGACCC|AAAGGGCGAGTGGGCACGTCGGCAGGGTTG
ACCCCGGACTTATGCGCAGATTGTGGCTAG|GGACAGGGACTGCAAACTCCTAGGCACGTC
AAATATCGTGGCTTGGTCACTGCTCGGCAC|TATTCCCTCCCGTCGGCCACGATATACGGA
TAGTTTCCACCTAGCCACAGCTTCCTGATC|GGCTTGGTCACTGCTCGGCACGTCGGCAGG
GATATACGGAACCCTGCGCGGCCGGCCGCC|CCCGAAAGGGCGTCGGTTTAATGCTGCCAA
GCAGGGTTGCCCGAAAGGGCGAGTGGGCAC|GGATCAACGCGGTGCGTCCGTTTCGTTTAA
GATTGATGGCACGTCGGCAGGGTTGGGCAC|GCAGGGTTGCCCGAAAGGGCGGACTACAAA
CAGCCGTAAAATACAGCCCAAACAGCCATG|CACGTCGGCAGGGTTGGGCACGTCGGCAGG
CCGGACTGCCTATGAGAACGGGTAGTAGGT|TAACCGAAGGCTGTTACCTGACTGAAAATA
CGCTATCGAGTTTGGGCACGTCGGCAGGGT|CTCATTAGTAGTCCAATTATAAGCCACTCC
CAAGTCAGCTAAAGCTTGCCGTATATACTT|TGATGTGGGTAAGGCACGTCGGCAGGGTTG
AACGCGGTGCGTCCGTTTCGTTTAACGGGT|GGTGTGATAGTTTCCACCTAGCCACAGCTT
CAGGGTTGCCCGAAAGGGCGCCCGAAAGGG|TAATTAGACTCAGCTTGTGAGGTGGTATAG
CTTGTGAGGTGGTATAGACTAGCACAAGCG|TGGCCTTTTACAGCTCCGCAACGCCATAAC
ACGATTGTTATCGCACCAGAGTGGCCTTTT|CGCTAATCCGGTCGGACAATCTCTGTAGTC
GAACCTTGCTGAGGGAATGTTTGCACGTTC|AGAATCCTTTCCGGACTGCCTATGAGAACG
GGGTTGCCCGAAAGGGCGTGACTCTCTTAT|CGTCGGCAGGGTTGCCCGAAAGGCACGTCG
CGGGGCGCTATCGAGTTTGGGCACGTCGGC|TATAACTCATTAGTAGTCCAATTATAAGCC
GAGAACGGGTAGTAGGTGTGATAGTTTCCA|TTACCTGACTGAAAATATCGTGGCTTGGTC
CGTGATGTGGGTAAGGCACGTCGGCAGGGT|ACTCGGTCGGTTAGAAAAGGGCACGTCGGC
AAGGCTGTTACCTGACTGAAAATATCGTGG|GAATAGGGCCTGTAGCGACTATTCCCTCCC
GTCGGCAGGGTTGCCCGAAAGGGCGAAAAG|GAAAGGGCGTGGGCAGCCGTAAAATACAGC
GACTATTCCCTCCCGTCGGCCACGATATAC|AAGTCGGCACGTCGGCAGGGTTGCCCGAAA
ATAGTTTCCACCTAGCCACAGCTTCCTGAT|TGGCTTGGTCACTGCTCGGCACGTCGGCAG
GACCGGCACGTCGGCAGGGTTGCCCGAAAG|GGGTTGCCCGAAAGGGCGTGGGCAGCCGTA
TAGCCAAATTATCATGGCGGGTCAACAGAC|GCGGGGCGCTATCGAGTTTGGGCACGTCGG
GGCATCGTTTTGACTTTGAACGCGACCCGT|AGGGCGAGTGGGCACGTCGGCAGGGTTGCC
AAAGGGCGAGTGGGCACGTCGGCAGGGTTG|GCGTCCGTTTCGTTTAACGGGTTTCGGGAG
TAGACTAGCACAAGCGTGATGTGGGTAAGG|TCCGCAACGCCATAACTCGGTCGGTTAGAA
GGAATGTTTGCACGTTCTCGGATCAACGCG|GACTGCCTATGAGAACGGGTAGTAGGTGTG
GTGACTCTCTTATTCGGGTCAGTTCACATG|GAAAGGCACGTCGGCAGGGTTGCCCGAAAG
ACAGACATGACCGGCACGTCGGCAGGGTTG|CGTCGGCAGGGTTGCCCGAAAGGGCGTGGG
CGATTGATGGCACGTCGGCAGGGTTGGGCA|GGCAGGGTTGCCCGAAAGGGCGGACTACAA
GTAGGTGTGATAGTTTCCACCTAGCCACAG|AAAATATCGTGGCTTGGTCACTGCTCGGCA
GGCACGTCGGCAGGGTTGCCCGAAAGGGCG|AATTATAAGCCACTCCACCCTATGCGATTG
CAGGGTTGGGCACGTCGGCAGGGTTGCCCG|GGCGGACTACAAATCCCGTAATTAGACTCA
CCCGAAAGGGCGCTAATCCGGTCGGACAAT|GGAGGCACGTCGGCAGGGTTGCCCGAAAGG
CGGCATCGTTTTGACTTTGAACGCGACCCG|AAGGGCGAGTGGGCACGTCGGCAGGGTTGC
AACGGGTTTCGGGAGGGAGGCACGTCGGCA|ACAGCTTCCTGATCCCCCATGTCGGAGTAT
CACTGCTCGGCACGTCGGCAGGGTTGCCCG|CACGATATACGGAACCCTGCGCGGCCGGCC
TGGCTAGGTCTCCACGAACCTCGTCCTTAA|GCACGTCGGCAGGGTTGCCCGAAAGGGCGC
ATGTTTGCACGTTCTCGGATCAACGCGGTG|TGCCTATGAGAACGGGTAGTAGGTGTGATA
CGGACTGCCTATGAGAACGGGTAGTAGGTG|AACCGAAGGCTGTTACCTGACTGAAAATAT
GAAAAGGGCACGTCGGCAGGGTTGCCCGAA|TGTTTGCACGTTCTCGGATCAACGCGGTGC
GTCGGCAGGGTTGCCCGAAAGGGCGCTAAT|CGGGTTTCGGGAGGGAGGCACGTCGGCAGG
GGCCTTTTACAGCTCCGCAACGCCATAACT|CTGTAGTCTTTTCATAGACACTTGAACCTT
GGCACGTCGGCAGGGTTGCCCGAAAGGGCG|AAAAGGGCACGTCGGCAGGGTTGCCCGAAA
TCCCGTCGGCCACGATATACGGAACCCTGC|GTCGGCAGGGTTGCCCGAAAGGGCGTCGGT
CTATTCCCTCCCGTCGGCCACGATATACGG|GTCGGCACGTCGGCAGGGTTGCCCGAAAGG
GCCTTTTACAGCTCCGCAACGCCATAACTC|TGTAGTCTTTTCATAGACACTTGAACCTTG
CGAAAGGGCGAATGGATGTTGCAAGTCAGC|TGGTATAGACTAGCACAAGCGTGATGTGGG
GTTCACATGCTAGCCAAATTATCATGGCGG|GCCCGAAAGGGCGGGGCGCTATCGAGTTTG
TGGGCACGTCGGCAGGGTTGCCCGAAAGGG|CCAATTATAAGCCACTCCACCCTATGCGAT
ATCGTTTTGACTTTGAACGCGACCCGTATG|GCGAGTGGGCACGTCGGCAGGGTTGCCCGA
CGAAAGGGCGTGGGCAGCCGTAAAATACAG|TATGCGATTGATGGCACGTCGGCAGGGTTG
GCGAATGGATGTTGCAAGTCAGCTAAAGCT|GACTAGCACAAGCGTGATGTGGGTAAGGCA
TGCAAACTCCTAGGCACGTCGGCAGGGTTG|TGATGAATAGCTCAGGTGATCATCAGGAGC
TGCCCGAAAGGGCGCCCGAAAGGGCGAATG|GACTCAGCTTGTGAGGTGGTATAGACTAGC
GACTGCCTATGAGAACGGGTAGTAGGTGTG|CCGAAGGCTGTTACCTGACTGAAAATATCG
GCCCGAAAGGGCGTGACTCTCTTATTCGGG|GCAGGGTTGCCCGAAAGGCACGTCGGCAGG
AGGCACGTCGGCAGGGTTGCCCGAAAGGGC|TCCGAACACGCAACAACTCCGGCGAAGCTT
TCGGCAGGGTTGCCCGAAAGGGCGAAATGT|GAGTATACCCCGGACTTATGCGCAGATTGT
GTTGCCCGAAAGGGCGGACTACAAATCCCG|TGAACGCGACCCGTATGGTGGTACGATTGT
CCGAAAGGGCGCTAATCCGGTCGGACAATC|GAGGCACGTCGGCAGGGTTGCCCGAAAGGG
GGGCACGTCGGCAGGGTTGCCCGAAAGGGC|GCACGTTCTCGGATCAACGCGGTGCGTCCG
TACTTTGGCGGGCCTGTTGGCACGTCGGCA|GGTTGCCCGAAAGGGCGGCATCGTTTTGAC
ACAACTCCGGCGAAGCTTATAACTCATTAG|TGGATGTTGCAAGTCAGCTAAAGCTTGCCG
GACTAGCACAAGCGTGATGTGGGTAAGGCA|CGCAACGCCATAACTCGGTCGGTTAGAAAA
CATGGCGGGTCAACAGACATGACCGGCACG|CGAGTTTGGGCACGTCGGCAGGGTTGCCCG
AGGGTTGCCCGAAAGGGCGAAATGTCACTG|TACCCCGGACTTATGCGCAGATTGTGGCTA
GCACGTCGGCAGGGTTGCCCGAAAGGCACG|CCATGCAGCGATACTTACAAGGTTCCGAAC
GGGCACGTCGGCAGGGTTGCCCGAAAGGGC|CAATTATAAGCCACTCCACCCTATGCGATT
CGAAAGGCACGTCGGCAGGGTTGCCCGAAA|AGGTTCCGAACACGCAACAACTCCGGCGAA
AAATGTCACTGGGCGAATGACGAGAATCCT|GATTGTGGCTAGGTCTCCACGAACCTCGTC
GGCAGGGTTGGGCACGTCGGCAGGGTTGCC|AGGGCGGACTACAAATCCCGTAATTAGACT
CGGCAGGGTTGCCCGAAAGGGCGCCCGAAA|CCGTAATTAGACTCAGCTTGTGAGGTGGTA
AGGGTTGCCCGAAAGGCACGTCGGCAGGGT|ATACTTACAAGGTTCCGAACACGCAACAAC
TTTCGGGAGGGAGGCACGTCGGCAGGGTTG|TCCTGATCCCCCATGTCGGAGTATACCCCG
GGAGTATACCCCGGACTTATGCGCAGATTG|AAGGGCGGGACAGGGACTGCAAACTCCTAG
GTGGCCTTTTACAGCTCCGCAACGCCATAA|CTCTGTAGTCTTTTCATAGACACTTGAACC
GGCAGGGTTGCCCGAAAGGGCGCATTGAAT|CATCAGGAGCTTATTGTACAGTTTTTCGTA
GGTTGCCCGAAAGGGCGTGGGCAGCCGTAA|TCCACCCTATGCGATTGATGGCACGTCGGC
ATTCGGGTCAGTTCACATGCTAGCCAAATT|CGGCAGGGTTGCCCGAAAGGGCGGGGCGCT
CCGAAAGGGCGGGGCGCTATCGAGTTTGGG|GGCGAAGCTTATAACTCATTAGTAGTCCAA
AAACAGCCATGCAGCGATACTTACAAGGTT|ACGTCGGCAGGGTTGCCCGAAAGGGCGCCC
AGGGTTGCCCGAAAGGGCGGGGCGCTATCG|ACAACTCCGGCGAAGCTTATAACTCATTAG
CTCCGCAACGCCATAACTCGGTCGGTTAGA|CATAGACACTTGAACCTTGCTGAGGGAATG
GATCCCCCATGTCGGAGTATACCCCGGACT|CAGGGTTGCCCGAAAGGGCGGGACAGGGAC
TGTAGCGACTATTCCCTCCCGTCGGCCACG|GCGTAAAAGTCGGCACGTCGGCAGGGTTGC
GGTCAACAGACATGACCGGCACGTCGGCAG|GGGCACGTCGGCAGGGTTGCCCGAAAGGGC
AAGGTTCCGAACACGCAACAACTCCGGCGA|GCGCCCGAAAGGGCGAATGGATGTTGCAAG
CGAGAATCCTTTCCGGACTGCCTATGAGAA|GAACCTCGTCCTTAACCGAAGGCTGTTACC
CGGGTCAGTTCACATGCTAGCCAAATTATC|CAGGGTTGCCCGAAAGGGCGGGGCGCTATC
GCAGGGTTGCCCGAAAGGGCGTGACTCTCT|GCACGTCGGCAGGGTTGCCCGAAAGGCACG
CATTAGTAGTCCAATTATAAGCCACTCCAC|TTGCCGTATATACTTTGGCGGGCCTGTTGG
CGGCAGGGTTGCCCGAAAGGGCGGACTACA|TTGACTTTGAACGCGACCCGTATGGTGGTA
AAGAGGCACGTCGGCAGGGTTGCCCGAAAG|AACAGCCATGCAGCGATACTTACAAGGTTC
GGCGGGCCTGTTGGCACGTCGGCAGGGTTG|CCGAAAGGGCGGCATCGTTTTGACTTTGAA
TAGCCACAGCTTCCTGATCCCCCATGTCGG|TGCTCGGCACGTCGGCAGGGTTGCCCGAAA
TACTGAGTTAAAATGTGTGGCACGTCGGCA|TGCCCGAAAGGGCGAAAAGGCCAAGAGGCA
GGCACGTCGGCAGGGTTGCCCGAAAGGGCG|CAGGTGATCATCAGGAGCTTATTGTACAGT
TCGTGGCTTGGTCACTGCTCGGCACGTCGG|CCTCCCGTCGGCCACGATATACGGAACCCT
AAGGGCGGGGCGCTATCGAGTTTGGGCACG|AAGCTTATAACTCATTAGTAGTCCAATTAT
CCGAAAGGGCGGACTACAAATCCCGTAATT|GCGACCCGTATGGTGGTACGATTGTTATCG
TTGAATAGGGCCTGTAGCGACTATTCCCTC|TTCGTAGCAGGTGCGTAAAAGTCGGCACGT
TATAACTCATTAGTAGTCCAATTATAAGCC|CTAAAGCTTGCCGTATATACTTTGGCGGGC
TGCCCGAAAGGGCGGGACAGGGACTGCAAA|CCGGCCGCCGATGGACGGAGAATGTGATGA
GCTGTTACCTGACTGAAAATATCGTGGCTT|TAGGGCCTGTAGCGACTATTCCCTCCCGTC
AGGTGGTATAGACTAGCACAAGCGTGATGT|TTTACAGCTCCGCAACGCCATAACTCGGTC
GCACCAGAGTGGCCTTTTACAGCTCCGCAA|CGGACAATCTCTGTAGTCTTTTCATAGACA
ATCGCACCAGAGTGGCCTTTTACAGCTCCG|GGTCGGACAATCTCTGTAGTCTTTTCATAG
GAACGCGACCCGTATGGTGGTACGATTGTT|CGGCAGGGTTGCCCGAAAGGGCGCTAATCC
GCAGGGTTGCCCGAAAGGCACGTCGGCAGG|CGATACTTACAAGGTTCCGAACACGCAACA
CAGTTCACATGCTAGCCAAATTATCATGGC|TTGCCCGAAAGGGCGGGGCGCTATCGAGTT
AACGCGACCCGTATGGTGGTACGATTGTTA|GGCAGGGTTGCCCGAAAGGGCGCTAATCCG
GCTAAAGCTTGCCGTATATACTTTGGCGGG|GGTAAGGCACGTCGGCAGGGTTGCCCGAAA
CGTCGGCAGGGTTGCCCGAAAGGGCGAAAA|CGAAAGGGCGTGGGCAGCCGTAAAATACAG
ACGTCGGCAGGGTTGCCCGAAAGGGCGGAC|CGTTTTGACTTTGAACGCGACCCGTATGGT
ACGTTCTCGGATCAACGCGGTGCGTCCGTT|AGAACGGGTAGTAGGTGTGATAGTTTCCAC
GGCGCTATCGAGTTTGGGCACGTCGGCAGG|AACTCATTAGTAGTCCAATTATAAGCCACT
ACAGGGACTGCAAACTCCTAGGCACGTCGG|GGAGAATGTGATGAATAGCTCAGGTGATCA
AGGGCGGGGCGCTATCGAGTTTGGGCACGT|AGCTTATAACTCATTAGTAGTCCAATTATA
TTGCCCGAAAGGGCGAGTGGGCACGTCGGC|ACGCGGTGCGTCCGTTTCGTTTAACGGGTT
AAAGGGCGAATGGATGTTGCAAGTCAGCTA|GTATAGACTAGCACAAGCGTGATGTGGGTA
GGGTTGCCCGAAAGGGCGAAAAGGCCAAGA|CGTGGGCAGCCGTAAAATACAGCCCAAACA
CACGTCGGCAGGGTTGCCCGAAAGGGCGGA|TCGTTTTGACTTTGAACGCGACCCGTATGG
CACGTCGGCAGGGTTGCCCGAAAGGGCGAG|CGTTCTCGGATCAACGCGGTGCGTCCGTTT
GCCTGTTGGCACGTCGGCAGGGTTGCCCGA|AGGGCGGCATCGTTTTGACTTTGAACGCGA
GTTTCGTTTAACGGGTTTCGGGAGGGAGGC|CACCTAGCCACAGCTTCCTGATCCCCCATG
TCAACGCGGTGCGTCCGTTTCGTTTAACGG|TAGGTGTGATAGTTTCCACCTAGCCACAGC
ACAGCCATGCAGCGATACTTACAAGGTTCC|GTCGGCAGGGTTGCCCGAAAGGGCGCCCGA
AACCTTGCTGAGGGAATGTTTGCACGTTCT|GAATCCTTTCCGGACTGCCTATGAGAACGG
TTCGTTTAACGGGTTTCGGGAGGGAGGCAC|CCTAGCCACAGCTTCCTGATCCCCCATGTC
GTCGGCAGGGTTGCCCGAAAGGGCGCATTG|GATCATCAGGAGCTTATTGTACAGTTTTTC
TCGGCAGGGTTGCCCGAAAGGGCGGCATCG|GCACGTCGGCAGGGTTGCCCGAAAGGGCGA
ACAATCTCTGTAGTCTTTTCATAGACACTT|AAAGGGCGAAATGTCACTGGGCGAATGACG
GCGCAGATTGTGGCTAGGTCTCCACGAACC|AAACTCCTAGGCACGTCGGCAGGGTTGCCC
ACGGGTAGTAGGTGTGATAGTTTCCACCTA|CTGACTGAAAATATCGTGGCTTGGTCACTG
CGCATTGAATAGGGCCTGTAGCGACTATTC|GTTTTTCGTAGCAGGTGCGTAAAAGTCGGC
ACTTTGGCGGGCCTGTTGGCACGTCGGCAG|GTTGCCCGAAAGGGCGGCATCGTTTTGACT
TGGATGTTGCAAGTCAGCTAAAGCTTGCCG|GCACAAGCGTGATGTGGGTAAGGCACGTCG
CCCGAAAGGGCGAGTGGGCACGTCGGCAGG|CGGTGCGTCCGTTTCGTTTAACGGGTTTCG
GTACGATTGTTATCGCACCAGAGTGGCCTT|GGCGCTAATCCGGTCGGACAATCTCTGTAG
GCCCGAAAGGGCGGCATCGTTTTGACTTTG|GGGTTGCCCGAAAGGGCGAGTGGGCACGTC
GTATAGACTAGCACAAGCGTGATGTGGGTA|AGCTCCGCAACGCCATAACTCGGTCGGTTA
TCGGCAGGGTTGCCCGAAAGGCACGTCGGC|CAGCGATACTTACAAGGTTCCGAACACGCA
CGGCGAAGCTTATAACTCATTAGTAGTCCA|TGCAAGTCAGCTAAAGCTTGCCGTATATAC
TAAAATGTGTGGCACGTCGGCAGGGTTGCC|AGGGCGAAAAGGCCAAGAGGCACGTCGGCA
TACAGCTCCGCAACGCCATAACTCGGTCGG|CTTTTCATAGACACTTGAACCTTGCTGAGG
CGGCAGGGTTGCCCGAAAGGGCGTGACTCT|AGGCACGTCGGCAGGGTTGCCCGAAAGGCA
TCCTAGGCACGTCGGCAGGGTTGCCCGAAA|TAGCTCAGGTGATCATCAGGAGCTTATTGT
TGACTTTGAACGCGACCCGTATGGTGGTAC|GGCACGTCGGCAGGGTTGCCCGAAAGGGCG
CGTCGGCAGGGTTGCCCGAAAGGGCGCCCG|ATCCCGTAATTAGACTCAGCTTGTGAGGTG
TGAACGCGACCCGTATGGTGGTACGATTGT|TCGGCAGGGTTGCCCGAAAGGGCGCTAATC
CTCGGTCGGTTAGAAAAGGGCACGTCGGCA|TTGCTGAGGGAATGTTTGCACGTTCTCGGA
AGTAGGTGTGATAGTTTCCACCTAGCCACA|GAAAATATCGTGGCTTGGTCACTGCTCGGC
CCGAAAGGGCGAAATGTCACTGGGCGAATG|ACTTATGCGCAGATTGTGGCTAGGTCTCCA
AGCTTCCTGATCCCCCATGTCGGAGTATAC|CACGTCGGCAGGGTTGCCCGAAAGGGCGGG
GACTGCAAACTCCTAGGCACGTCGGCAGGG|ATGTGATGAATAGCTCAGGTGATCATCAGG
GGACTACAAATCCCGTAATTAGACTCAGCT|TGGTGGTACGATTGTTATCGCACCAGAGTG
GGCACGTCGGCAGGGTTGCCCGAAAGGGCG|ACAAATCCCGTAATTAGACTCAGCTTGTGA
GACTCAGCTTGTGAGGTGGTATAGACTAGC|ACCAGAGTGGCCTTTTACAGCTCCGCAACG
GTAATTAGACTCAGCTTGTGAGGTGGTATA|TTATCGCACCAGAGTGGCCTTTTACAGCTC
GGTCGGACAATCTCTGTAGTCTTTTCATAG|TGCCCGAAAGGGCGAAATGTCACTGGGCGA
AGACACTTGAACCTTGCTGAGGGAATGTTT|GAATGACGAGAATCCTTTCCGGACTGCCTA
GCAGGGTTGCCCGAAAGGGCGCCCGAAAGG|GTAATTAGACTCAGCTTGTGAGGTGGTATA
CAGCTAAAGCTTGCCGTATATACTTTGGCG|TGGGTAAGGCACGTCGGCAGGGTTGCCCGA
AAATCCCGTAATTAGACTCAGCTTGTGAGG|ACGATTGTTATCGCACCAGAGTGGCCTTTT
AGGGTTGCCCGAAAGGGCGCATTGAATAGG|CAGGAGCTTATTGTACAGTTTTTCGTAGCA
TCTCTGTAGTCTTTTCATAGACACTTGAAC|GGCGAAATGTCACTGGGCGAATGACGAGAA
TCCGTTTCGTTTAACGGGTTTCGGGAGGGA|TTCCACCTAGCCACAGCTTCCTGATCCCCC
AGGGCGAATGGATGTTGCAAGTCAGCTAAA|ATAGACTAGCACAAGCGTGATGTGGGTAAG
GTTAAAATGTGTGGCACGTCGGCAGGGTTG|AAAGGGCGAAAAGGCCAAGAGGCACGTCGG
TCGAGTTTGGGCACGTCGGCAGGGTTGCCC|TAGTAGTCCAATTATAAGCCACTCCACCCT
GTGGTACGATTGTTATCGCACCAGAGTGGC|AAGGGCGCTAATCCGGTCGGACAATCTCTG
CAACAGACATGACCGGCACGTCGGCAGGGT|CACGTCGGCAGGGTTGCCCGAAAGGGCGTG
CACGAACCTCGTCCTTAACCGAAGGCTGTT|GGTTGCCCGAAAGGGCGCATTGAATAGGGC
TGAATAGGGCCTGTAGCGACTATTCCCTCC|TCGTAGCAGGTGCGTAAAAGTCGGCACGTC
CAGCCCAAACAGCCATGCAGCGATACTTAC|TTGGGCACGTCGGCAGGGTTGCCCGAAAGG
AACTCCGGCGAAGCTTATAACTCATTAGTA|GATGTTGCAAGTCAGCTAAAGCTTGCCGTA
ACGTCGGCAGGGTTGCCCGAAAGGGCGAAA|CCGAAAGGGCGTGGGCAGCCGTAAAATACA
GGACAGGGACTGCAAACTCCTAGGCACGTC|ACGGAGAATGTGATGAATAGCTCAGGTGAT
CTCCACCCTATGCGATTGATGGCACGTCGG|TGTTGGCACGTCGGCAGGGTTGCCCGAAAG
CGGCAGGGTTGCCCGAAAGGGCGTGGGCAG|AGCCACTCCACCCTATGCGATTGATGGCAC
TCGTCCTTAACCGAAGGCTGTTACCTGACT|GAAAGGGCGCATTGAATAGGGCCTGTAGCG
GTGGGCACGTCGGCAGGGTTGCCCGAAAGG|TCGTTTAACGGGTTTCGGGAGGGAGGCACG
CACGTCGGCAGGGTTGCCCGAAAGGGCGTG|CCAAGAGGCACGTCGGCAGGGTTGCCCGAA
GTGATGTGGGTAAGGCACGTCGGCAGGGTT|CTCGGTCGGTTAGAAAAGGGCACGTCGGCA
AGTTCACATGCTAGCCAAATTATCATGGCG|TGCCCGAAAGGGCGGGGCGCTATCGAGTTT
AACAGACATGACCGGCACGTCGGCAGGGTT|ACGTCGGCAGGGTTGCCCGAAAGGGCGTGG
GGCGAATGACGAGAATCCTTTCCGGACTGC|GGTCTCCACGAACCTCGTCCTTAACCGAAG
ACGTCGGCAGGGTTGCCCGAAAGGGCGCCC|AATCCCGTAATTAGACTCAGCTTGTGAGGT
ACCGAAGGCTGTTACCTGACTGAAAATATC|CATTGAATAGGGCCTGTAGCGACTATTCCC
GCGGGTCAACAGACATGACCGGCACGTCGG|TTTGGGCACGTCGGCAGGGTTGCCCGAAAG
CGAAAGGGCGGGGCGCTATCGAGTTTGGGC|GCGAAGCTTATAACTCATTAGTAGTCCAAT
TGGGCACGTCGGCAGGGTTGCCCGAAAGGG|CGTTTAACGGGTTTCGGGAGGGAGGCACGT
AGGGCGAAATGTCACTGGGCGAATGACGAG|TGCGCAGATTGTGGCTAGGTCTCCACGAAC
CCGTTTCGTTTAACGGGTTTCGGGAGGGAG|TCCACCTAGCCACAGCTTCCTGATCCCCCA
TCGGACAATCTCTGTAGTCTTTTCATAGAC|CCCGAAAGGGCGAAATGTCACTGGGCGAAT
AAAGGCCAAGAGGCACGTCGGCAGGGTTGC|CAGCCCAAACAGCCATGCAGCGATACTTAC
GGGCGGACTACAAATCCCGTAATTAGACTC|CGTATGGTGGTACGATTGTTATCGCACCAG
CCTGATCCCCCATGTCGGAGTATACCCCGG|CGGCAGGGTTGCCCGAAAGGGCGGGACAGG
GGCAGGGTTGCCCGAAAGGGCGCCCGAAAG|CGTAATTAGACTCAGCTTGTGAGGTGGTAT
GGTGGTACGATTGTTATCGCACCAGAGTGG|AAAGGGCGCTAATCCGGTCGGACAATCTCT
GTCAGCTAAAGCTTGCCGTATATACTTTGG|TGTGGGTAAGGCACGTCGGCAGGGTTGCCC
CGAAAGGGCGTGACTCTCTTATTCGGGTCA|GGGTTGCCCGAAAGGCACGTCGGCAGGGTT
TCGTTTTGACTTTGAACGCGACCCGTATGG|CGAGTGGGCACGTCGGCAGGGTTGCCCGAA
CCACGATATACGGAACCCTGCGCGGCCGGC|GTTGCCCGAAAGGGCGTCGGTTTAATGCTG
TGGCACGTCGGCAGGGTTGCCCGAAAGGGC|GCATCGTTTTGACTTTGAACGCGACCCGTA
ATCCGGTCGGACAATCTCTGTAGTCTTTTC|GGGTTGCCCGAAAGGGCGAAATGTCACTGG
GTCGGCAGGGTTGCCCGAAAGGCACGTCGG|GCAGCGATACTTACAAGGTTCCGAACACGC
GGTCTCCACGAACCTCGTCCTTAACCGAAG|CGGCAGGGTTGCCCGAAAGGGCGCATTGAA
CTGCCTATGAGAACGGGTAGTAGGTGTGAT|GAAGGCTGTTACCTGACTGAAAATATCGTG
TCGGATCAACGCGGTGCGTCCGTTTCGTTT|GGTAGTAGGTGTGATAGTTTCCACCTAGCC
GAGTATACCCCGGACTTATGCGCAGATTGT|AGGGCGGGACAGGGACTGCAAACTCCTAGG
CAGAGTGGCCTTTTACAGCTCCGCAACGCC|CAATCTCTGTAGTCTTTTCATAGACACTTG
TGCCCGAAAGGGCGAAATGTCACTGGGCGA|CGGACTTATGCGCAGATTGTGGCTAGGTCT
GGCGAATGGATGTTGCAAGTCAGCTAAAGC|AGACTAGCACAAGCGTGATGTGGGTAAGGC
ACTGCCTATGAGAACGGGTAGTAGGTGTGA|CGAAGGCTGTTACCTGACTGAAAATATCGT
GCAGGGTTGCCCGAAAGGGCGAAATGTCAC|TATACCCCGGACTTATGCGCAGATTGTGGC
CGTAAAATACAGCCCAAACAGCCATGCAGC|TCGGCAGGGTTGGGCACGTCGGCAGGGTTG
ATGTTGCAAGTCAGCTAAAGCTTGCCGTAT|CAAGCGTGATGTGGGTAAGGCACGTCGGCA
GTGTGATAGTTTCCACCTAGCCACAGCTTC|TATCGTGGCTTGGTCACTGCTCGGCACGTC
TACTTACAAGGTTCCGAACACGCAACAACT|CGAAAGGGCGCCCGAAAGGGCGAATGGATG
GCAACAACTCCGGCGAAGCTTATAACTCAT|GAATGGATGTTGCAAGTCAGCTAAAGCTTG
ACGTCGGCAGGGTTGCCCGAAAGGGCGTGA|CAAGAGGCACGTCGGCAGGGTTGCCCGAAA
GGGTTGCCCGAAAGGGCGGCATCGTTTTGA|CGGCAGGGTTGCCCGAAAGGGCGAGTGGGC
ACGATATACGGAACCCTGCGCGGCCGGCCG|TGCCCGAAAGGGCGTCGGTTTAATGCTGCC
GCCCGAAAGGGCGAAAAGGCCAAGAGGCAC|GCAGCCGTAAAATACAGCCCAAACAGCCAT
GTTGCCCGAAAGGCACGTCGGCAGGGTTGC|CTTACAAGGTTCCGAACACGCAACAACTCC
TATTCGGGTCAGTTCACATGCTAGCCAAAT|TCGGCAGGGTTGCCCGAAAGGGCGGGGCGC
AGTTTCCACCTAGCCACAGCTTCCTGATCC|GCTTGGTCACTGCTCGGCACGTCGGCAGGG
CGTCCTTAACCGAAGGCTGTTACCTGACTG|AAAGGGCGCATTGAATAGGGCCTGTAGCGA
GTCAGTTCACATGCTAGCCAAATTATCATG|GGTTGCCCGAAAGGGCGGGGCGCTATCGAG
AAGCCACTCCACCCTATGCGATTGATGGCA|CGGGCCTGTTGGCACGTCGGCAGGGTTGCC
GGGCCTGTTGGCACGTCGGCAGGGTTGCCC|AAAGGGCGGCATCGTTTTGACTTTGAACGC
GGGTTGCCCGAAAGGCACGTCGGCAGGGTT|TACTTACAAGGTTCCGAACACGCAACAACT
CGGCAGGGTTGCCCGAAAGGCACGTCGGCA|AGCGATACTTACAAGGTTCCGAACACGCAA
GTCGGCAGGGTTGGGCACGTCGGCAGGGTT|GAAAGGGCGGACTACAAATCCCGTAATTAG
AGAATCCTTTCCGGACTGCCTATGAGAACG|ACCTCGTCCTTAACCGAAGGCTGTTACCTG
CGCGGTGCGTCCGTTTCGTTTAACGGGTTT|TGTGATAGTTTCCACCTAGCCACAGCTTCC
ACAGCCCAAACAGCCATGCAGCGATACTTA|GTTGGGCACGTCGGCAGGGTTGCCCGAAAG
ACCTCGTCCTTAACCGAAGGCTGTTACCTG|CCCGAAAGGGCGCATTGAATAGGGCCTGTA
GGCACGTCGGCAGGGTTGCCCGAAAGGGCG|CCGAACACGCAACAACTCCGGCGAAGCTTA
AAGGGCGTGACTCTCTTATTCGGGTCAGTT|TTGCCCGAAAGGCACGTCGGCAGGGTTGCC
AAAGGCACGTCGGCAGGGTTGCCCGAAAGG|GTTCCGAACACGCAACAACTCCGGCGAAGC
GTGGCTTGGTCACTGCTCGGCACGTCGGCA|TCCCGTCGGCCACGATATACGGAACCCTGC
CGGCAGGGTTGCCCGAAAGGGCGGGACAGG|CCTGCGCGGCCGGCCGCCGATGGACGGAGA
AGACTCAGCTTGTGAGGTGGTATAGACTAG|CACCAGAGTGGCCTTTTACAGCTCCGCAAC
GCGCCCGAAAGGGCGAATGGATGTTGCAAG|TGAGGTGGTATAGACTAGCACAAGCGTGAT
TGAGGGAATGTTTGCACGTTCTCGGATCAA|TCCGGACTGCCTATGAGAACGGGTAGTAGG
CGCCATAACTCGGTCGGTTAGAAAAGGGCA|CTTGAACCTTGCTGAGGGAATGTTTGCACG
TCACTGGGCGAATGACGAGAATCCTTTCCG|TGGCTAGGTCTCCACGAACCTCGTCCTTAA
AAGCTTGCCGTATATACTTTGGCGGGCCTG|AGGCACGTCGGCAGGGTTGCCCGAAAGGGC
AGAGTGGCCTTTTACAGCTCCGCAACGCCA|AATCTCTGTAGTCTTTTCATAGACACTTGA
AGGTTCCGAACACGCAACAACTCCGGCGAA|CGCCCGAAAGGGCGAATGGATGTTGCAAGT
GCACGTCGGCAGGGTTGCCCGAAAGGGCGC|AGGTGATCATCAGGAGCTTATTGTACAGTT
CTCCGGCGAAGCTTATAACTCATTAGTAGT|TGTTGCAAGTCAGCTAAAGCTTGCCGTATA
TTATGCGCAGATTGTGGCTAGGTCTCCACG|CTGCAAACTCCTAGGCACGTCGGCAGGGTT
TCCACCTAGCCACAGCTTCCTGATCCCCCA|GGTCACTGCTCGGCACGTCGGCAGGGTTGC
CATAGACACTTGAACCTTGCTGAGGGAATG|GGCGAATGACGAGAATCCTTTCCGGACTGC
GCACAAGCGTGATGTGGGTAAGGCACGTCG|CGCCATAACTCGGTCGGTTAGAAAAGGGCA
GTTGGGCACGTCGGCAGGGTTGCCCGAAAG|GACTACAAATCCCGTAATTAGACTCAGCTT
AACAACTCCGGCGAAGCTTATAACTCATTA|ATGGATGTTGCAAGTCAGCTAAAGCTTGCC
CTGAGTTAAAATGTGTGGCACGTCGGCAGG|CCCGAAAGGGCGAAAAGGCCAAGAGGCACG
CGTCGGCAGGGTTGCCCGAAAGGGCGGACT|GTTTTGACTTTGAACGCGACCCGTATGGTG
GCACGTTCTCGGATCAACGCGGTGCGTCCG|TGAGAACGGGTAGTAGGTGTGATAGTTTCC
CGGGACAGGGACTGCAAACTCCTAGGCACG|GGACGGAGAATGTGATGAATAGCTCAGGTG
TAGTCCAATTATAAGCCACTCCACCCTATG|TATATACTTTGGCGGGCCTGTTGGCACGTC
ACTCCGGCGAAGCTTATAACTCATTAGTAG|ATGTTGCAAGTCAGCTAAAGCTTGCCGTAT
AACGGGTAGTAGGTGTGATAGTTTCCACCT|CCTGACTGAAAATATCGTGGCTTGGTCACT
CAAGCGTGATGTGGGTAAGGCACGTCGGCA|CATAACTCGGTCGGTTAGAAAAGGGCACGT
CAAACAGCCATGCAGCGATACTTACAAGGT|CACGTCGGCAGGGTTGCCCGAAAGGGCGCC
GCGTGATGTGGGTAAGGCACGTCGGCAGGG|AACTCGGTCGGTTAGAAAAGGGCACGTCGG
AGGGCGGACTACAAATCCCGTAATTAGACT|CCGTATGGTGGTACGATTGTTATCGCACCA
TTTGCACGTTCTCGGATCAACGCGGTGCGT|CTATGAGAACGGGTAGTAGGTGTGATAGTT
CCCGAAAGGGCGCATTGAATAGGGCCTGTA|TTATTGTACAGTTTTTCGTAGCAGGTGCGT
TTACAAGGTTCCGAACACGCAACAACTCCG|AAGGGCGCCCGAAAGGGCGAATGGATGTTG
AAAGGGCACGTCGGCAGGGTTGCCCGAAAG|TTTGCACGTTCTCGGATCAACGCGGTGCGT
CTGAAAATATCGTGGCTTGGTCACTGCTCG|CGACTATTCCCTCCCGTCGGCCACGATATA
TATACTTTGGCGGGCCTGTTGGCACGTCGG|AGGGTTGCCCGAAAGGGCGGCATCGTTTTG
TCTTATTCGGGTCAGTTCACATGCTAGCCA|ACGTCGGCAGGGTTGCCCGAAAGGGCGGGG
TATCGAGTTTGGGCACGTCGGCAGGGTTGC|ATTAGTAGTCCAATTATAAGCCACTCCACC
GTGTGGCACGTCGGCAGGGTTGCCCGAAAG|AAAAGGCCAAGAGGCACGTCGGCAGGGTTG
CGAGTGGGCACGTCGGCAGGGTTGCCCGAA|GTTTCGTTTAACGGGTTTCGGGAGGGAGGC
CACGTCGGCAGGGTTGCCCGAAAGGGCGAA|CCCGAAAGGGCGTGGGCAGCCGTAAAATAC
GAATGTTTGCACGTTCTCGGATCAACGCGG|ACTGCCTATGAGAACGGGTAGTAGGTGTGA
TACAAGGTTCCGAACACGCAACAACTCCGG|AGGGCGCCCGAAAGGGCGAATGGATGTTGC
GCATCGTTTTGACTTTGAACGCGACCCGTA|GGGCGAGTGGGCACGTCGGCAGGGTTGCCC
GTCCGTTTCGTTTAACGGGTTTCGGGAGGG|TTTCCACCTAGCCACAGCTTCCTGATCCCC
CGGACAATCTCTGTAGTCTTTTCATAGACA|CCGAAAGGGCGAAATGTCACTGGGCGAATG
TGGCACGTCGGCAGGGTTGCCCGAAAGGGC|AGGCCAAGAGGCACGTCGGCAGGGTTGCCC
ACCCGTATGGTGGTACGATTGTTATCGCAC|GTTGCCCGAAAGGGCGCTAATCCGGTCGGA
TGCTGAGGGAATGTTTGCACGTTCTCGGAT|CTTTCCGGACTGCCTATGAGAACGGGTAGT
CAGATTGTGGCTAGGTCTCCACGAACCTCG|CTCCTAGGCACGTCGGCAGGGTTGCCCGAA
CCGGACTTATGCGCAGATTGTGGCTAGGTC|CAGGGACTGCAAACTCCTAGGCACGTCGGC
GGGCACGTCGGCAGGGTTGCCCGAAAGGGC|TACAAATCCCGTAATTAGACTCAGCTTGTG
GGCCAAGAGGCACGTCGGCAGGGTTGCCCG|CCCAAACAGCCATGCAGCGATACTTACAAG
GCAGCGATACTTACAAGGTTCCGAACACGC|GGTTGCCCGAAAGGGCGCCCGAAAGGGCGA
GATGGCACGTCGGCAGGGTTGGGCACGTCG|GGTTGCCCGAAAGGGCGGACTACAAATCCC
AGGGTTGCCCGAAAGGGCGTGGGCAGCCGT|ACTCCACCCTATGCGATTGATGGCACGTCG
TTTGGCGGGCCTGTTGGCACGTCGGCAGGG|TGCCCGAAAGGGCGGCATCGTTTTGACTTT
GAGTGGGCACGTCGGCAGGGTTGCCCGAAA|TTTCGTTTAACGGGTTTCGGGAGGGAGGCA
TAAGGCACGTCGGCAGGGTTGCCCGAAAGG|TAGAAAAGGGCACGTCGGCAGGGTTGCCCG
TGCCCGAAAGGGCGAAAAGGCCAAGAGGCA|GGCAGCCGTAAAATACAGCCCAAACAGCCA
GCGAATGACGAGAATCCTTTCCGGACTGCC|GTCTCCACGAACCTCGTCCTTAACCGAAGG
GCCAAGAGGCACGTCGGCAGGGTTGCCCGA|CCAAACAGCCATGCAGCGATACTTACAAGG
TCATGGCGGGTCAACAGACATGACCGGCAC|TCGAGTTTGGGCACGTCGGCAGGGTTGCCC
GTTTGCACGTTCTCGGATCAACGCGGTGCG|CCTATGAGAACGGGTAGTAGGTGTGATAGT
GGCAGGGTTGCCCGAAAGGGCGTGACTCTC|GGCACGTCGGCAGGGTTGCCCGAAAGGCAC
TTCCGGACTGCCTATGAGAACGGGTAGTAG|CTTAACCGAAGGCTGTTACCTGACTGAAAA
GCCCGAAAGGGCGCCCGAAAGGGCGAATGG|ACTCAGCTTGTGAGGTGGTATAGACTAGCA
GCAGCCGTAAAATACAGCCCAAACAGCCAT|GCACGTCGGCAGGGTTGGGCACGTCGGCAG
TATGAGAACGGGTAGTAGGTGTGATAGTTT|CTGTTACCTGACTGAAAATATCGTGGCTTG
GCAGGGTTGCCCGAAAGGGCGGGACAGGGA|TGCGCGGCCGGCCGCCGATGGACGGAGAAT
CTCAGCTTGTGAGGTGGTATAGACTAGCAC|CAGAGTGGCCTTTTACAGCTCCGCAACGCC
CCGTAATTAGACTCAGCTTGTGAGGTGGTA|TGTTATCGCACCAGAGTGGCCTTTTACAGC
ACTGAAAATATCGTGGCTTGGTCACTGCTC|GCGACTATTCCCTCCCGTCGGCCACGATAT
TTCGGGAGGGAGGCACGTCGGCAGGGTTGC|CCTGATCCCCCATGTCGGAGTATACCCCGG
AAAGGGCGCATTGAATAGGGCCTGTAGCGA|TGTACAGTTTTTCGTAGCAGGTGCGTAAAA
GTCGGACAATCTCTGTAGTCTTTTCATAGA|GCCCGAAAGGGCGAAATGTCACTGGGCGAA
ATCGTGGCTTGGTCACTGCTCGGCACGTCG|CCCTCCCGTCGGCCACGATATACGGAACCC
AATTATCATGGCGGGTCAACAGACATGACC|CGCTATCGAGTTTGGGCACGTCGGCAGGGT
ACCGGCACGTCGGCAGGGTTGCCCGAAAGG|GGTTGCCCGAAAGGGCGTGGGCAGCCGTAA
GAAAGGGCGGCATCGTTTTGACTTTGAACG|TGCCCGAAAGGGCGAGTGGGCACGTCGGCA
GGCTAGGTCTCCACGAACCTCGTCCTTAAC|CACGTCGGCAGGGTTGCCCGAAAGGGCGCA
CGAACACGCAACAACTCCGGCGAAGCTTAT|AAAGGGCGAATGGATGTTGCAAGTCAGCTA
TGTGGCACGTCGGCAGGGTTGCCCGAAAGG|AAAGGCCAAGAGGCACGTCGGCAGGGTTGC
AATATCGTGGCTTGGTCACTGCTCGGCACG|ATTCCCTCCCGTCGGCCACGATATACGGAA
CTTGCTGAGGGAATGTTTGCACGTTCTCGG|TCCTTTCCGGACTGCCTATGAGAACGGGTA
ATGCTAGCCAAATTATCATGGCGGGTCAAC|AAGGGCGGGGCGCTATCGAGTTTGGGCACG
ACGCGGTGCGTCCGTTTCGTTTAACGGGTT|GTGTGATAGTTTCCACCTAGCCACAGCTTC
TTTAACGGGTTTCGGGAGGGAGGCACGTCG|GCCACAGCTTCCTGATCCCCCATGTCGGAG
CACTGGGCGAATGACGAGAATCCTTTCCGG|GGCTAGGTCTCCACGAACCTCGTCCTTAAC
TCATAGACACTTGAACCTTGCTGAGGGAAT|GGGCGAATGACGAGAATCCTTTCCGGACTG
AAGGGCGTGGGCAGCCGTAAAATACAGCCC|GCGATTGATGGCACGTCGGCAGGGTTGGGC
ACTTACAAGGTTCCGAACACGCAACAACTC|GAAAGGGCGCCCGAAAGGGCGAATGGATGT
CCACGAACCTCGTCCTTAACCGAAGGCTGT|GGGTTGCCCGAAAGGGCGCATTGAATAGGG
ACTCGGTCGGTTAGAAAAGGGCACGTCGGC|CTTGCTGAGGGAATGTTTGCACGTTCTCGG
CCCGTAATTAGACTCAGCTTGTGAGGTGGT|TTGTTATCGCACCAGAGTGGCCTTTTACAG
GCCCGAAAGGGCGGACTACAAATCCCGTAA|ACGCGACCCGTATGGTGGTACGATTGTTAT
CGTCGGCAGGGTTGCCCGAAAGGGCGCTAA|ACGGGTTTCGGGAGGGAGGCACGTCGGCAG
TGGTGGTACGATTGTTATCGCACCAGAGTG|GAAAGGGCGCTAATCCGGTCGGACAATCTC
GAGAATCCTTTCCGGACTGCCTATGAGAAC|AACCTCGTCCTTAACCGAAGGCTGTTACCT
AGGCACGTCGGCAGGGTTGCCCGAAAGGCA|AGCCATGCAGCGATACTTACAAGGTTCCGA
ATGTCACTGGGCGAATGACGAGAATCCTTT|TTGTGGCTAGGTCTCCACGAACCTCGTCCT
AATTATAAGCCACTCCACCCTATGCGATTG|CTTTGGCGGGCCTGTTGGCACGTCGGCAGG
ACGTCGGCAGGGTTGCCCGAAAGGGCGAGT|GTTCTCGGATCAACGCGGTGCGTCCGTTTC
CTTACAAGGTTCCGAACACGCAACAACTCC|AAAGGGCGCCCGAAAGGGCGAATGGATGTT
GGGTTGCCCGAAAGGGCGCATTGAATAGGG|AGGAGCTTATTGTACAGTTTTTCGTAGCAG
GCCACAGCTTCCTGATCCCCCATGTCGGAG|CTCGGCACGTCGGCAGGGTTGCCCGAAAGG
CGTCGGCAGGGTTGCCCGAAAGGGCGTGGG|ATAAGCCACTCCACCCTATGCGATTGATGG
CCGTATGGTGGTACGATTGTTATCGCACCA|TGCCCGAAAGGGCGCTAATCCGGTCGGACA
GCACGTCGGCAGGGTTGCCCGAAAGGGCGT|GCCAAGAGGCACGTCGGCAGGGTTGCCCGA
CAGGGTTGCCCGAAAGGGCGAAAAGGCCAA|GGCGTGGGCAGCCGTAAAATACAGCCCAAA
GCCCGAAAGGGCGTGGGCAGCCGTAAAATA|CCCTATGCGATTGATGGCACGTCGGCAGGG
AAGCGTGATGTGGGTAAGGCACGTCGGCAG|ATAACTCGGTCGGTTAGAAAAGGGCACGTC
TCGCACCAGAGTGGCCTTTTACAGCTCCGC|GTCGGACAATCTCTGTAGTCTTTTCATAGA
GGCGAGTGGGCACGTCGGCAGGGTTGCCCG|CCGTTTCGTTTAACGGGTTTCGGGAGGGAG
CCAGAGTGGCCTTTTACAGCTCCGCAACGC|ACAATCTCTGTAGTCTTTTCATAGACACTT
CAGGGTTGCCCGAAAGGGCGGGGCGCTATC|AACAACTCCGGCGAAGCTTATAACTCATTA
TGTGGGTAAGGCACGTCGGCAGGGTTGCCC|GTCGGTTAGAAAAGGGCACGTCGGCAGGGT
TTGCCCGAAAGGGCGGGACAGGGACTGCAA|GCCGGCCGCCGATGGACGGAGAATGTGATG
CGAAAGGGCGCCCGAAAGGGCGAATGGATG|CAGCTTGTGAGGTGGTATAGACTAGCACAA
AATAGGGCCTGTAGCGACTATTCCCTCCCG|GTAGCAGGTGCGTAAAAGTCGGCACGTCGG
TGTTACCTGACTGAAAATATCGTGGCTTGG|GGGCCTGTAGCGACTATTCCCTCCCGTCGG
CAAGAGGCACGTCGGCAGGGTTGCCCGAAA|AAACAGCCATGCAGCGATACTTACAAGGTT
GCACGTCGGCAGGGTTGCCCGAAAGGGCGG|AAAGGGCACGTCGGCAGGGTTGCCCGAAAG
GTAAGGCACGTCGGCAGGGTTGCCCGAAAG|TTAGAAAAGGGCACGTCGGCAGGGTTGCCC
ACATGACCGGCACGTCGGCAGGGTTGCCCG|GGCAGGGTTGCCCGAAAGGGCGTGGGCAGC
GGGTTGGGCACGTCGGCAGGGTTGCCCGAA|CGGACTACAAATCCCGTAATTAGACTCAGC
CGCACCAGAGTGGCCTTTTACAGCTCCGCA|TCGGACAATCTCTGTAGTCTTTTCATAGAC
GTCGGCAGGGTTGCCCGAAAGGGCGAAATG|GGAGTATACCCCGGACTTATGCGCAGATTG
ACTACAAATCCCGTAATTAGACTCAGCTTG|GTGGTACGATTGTTATCGCACCAGAGTGGC
GCATTGAATAGGGCCTGTAGCGACTATTCC|TTTTTCGTAGCAGGTGCGTAAAAGTCGGCA
ACGTCGGCAGGGTTGCCCGAAAGGGCGGCA|AGGGCACGTCGGCAGGGTTGCCCGAAAGGG
GGTTAGAAAAGGGCACGTCGGCAGGGTTGC|GGGAATGTTTGCACGTTCTCGGATCAACGC
CGAAAGGGCGGGACAGGGACTGCAAACTCC|CCGCCGATGGACGGAGAATGTGATGAATAG
ATCCCCCATGTCGGAGTATACCCCGGACTT|AGGGTTGCCCGAAAGGGCGGGACAGGGACT
TGCGATTGATGGCACGTCGGCAGGGTTGGG|TCGGCAGGGTTGCCCGAAAGGGCGGACTAC
AGCACAAGCGTGATGTGGGTAAGGCACGTC|ACGCCATAACTCGGTCGGTTAGAAAAGGGC
TCACTGCTCGGCACGTCGGCAGGGTTGCCC|CCACGATATACGGAACCCTGCGCGGCCGGC
TGACTCTCTTATTCGGGTCAGTTCACATGC|AAAGGCACGTCGGCAGGGTTGCCCGAAAGG
CTGTTGGCACGTCGGCAGGGTTGCCCGAAA|GGCGGCATCGTTTTGACTTTGAACGCGACC
AAGGGCACGTCGGCAGGGTTGCCCGAAAGG|TTGCACGTTCTCGGATCAACGCGGTGCGTC
ACGTCGGCAGGGTTGCCCGAAAGGGCGGGG|AACACGCAACAACTCCGGCGAAGCTTATAA
GGGCGCTAATCCGGTCGGACAATCTCTGTA|CGTCGGCAGGGTTGCCCGAAAGGGCGAAAT
GTCGGCAGGGTTGCCCGAAAGGGCGGGGCG|CACGCAACAACTCCGGCGAAGCTTATAACT
CCTTAACCGAAGGCTGTTACCTGACTGAAA|GGGCGCATTGAATAGGGCCTGTAGCGACTA
CCCGAAAGGGCGAAAAGGCCAAGAGGCACG|CAGCCGTAAAATACAGCCCAAACAGCCATG
CAGGGACTGCAAACTCCTAGGCACGTCGGC|GAGAATGTGATGAATAGCTCAGGTGATCAT
GTGATAGTTTCCACCTAGCCACAGCTTCCT|TCGTGGCTTGGTCACTGCTCGGCACGTCGG
GGGACTGCAAACTCCTAGGCACGTCGGCAG|GAATGTGATGAATAGCTCAGGTGATCATCA
GCAGGGTTGGGCACGTCGGCAGGGTTGCCC|GGGCGGACTACAAATCCCGTAATTAGACTC
GTGGGCAGCCGTAAAATACAGCCCAAACAG|GATGGCACGTCGGCAGGGTTGGGCACGTCG
TTCGGGTCAGTTCACATGCTAGCCAAATTA|GGCAGGGTTGCCCGAAAGGGCGGGGCGCTA
CGAAAGGGCGAAATGTCACTGGGCGAATGA|CTTATGCGCAGATTGTGGCTAGGTCTCCAC
TCGGCAGGGTTGCCCGAAAGGGCGCCCGAA|CCCGTAATTAGACTCAGCTTGTGAGGTGGT
AGCTCCGCAACGCCATAACTCGGTCGGTTA|TTCATAGACACTTGAACCTTGCTGAGGGAA
TCGTTTAACGGGTTTCGGGAGGGAGGCACG|CTAGCCACAGCTTCCTGATCCCCCATGTCG
CCATGTCGGAGTATACCCCGGACTTATGCG|TGCCCGAAAGGGCGGGACAGGGACTGCAAA
TATTCCCTCCCGTCGGCCACGATATACGGA|TCGGCACGTCGGCAGGGTTGCCCGAAAGGG
CCGGTCGGACAATCTCTGTAGTCTTTTCAT|GTTGCCCGAAAGGGCGAAATGTCACTGGGC
ACCCTATGCGATTGATGGCACGTCGGCAGG|GGCACGTCGGCAGGGTTGCCCGAAAGGGCG
GGAGGCACGTCGGCAGGGTTGCCCGAAAGG|CCCATGTCGGAGTATACCCCGGACTTATGC
CGTTTTGACTTTGAACGCGACCCGTATGGT|GAGTGGGCACGTCGGCAGGGTTGCCCGAAA
TTGCCCGAAAGGGCGCCCGAAAGGGCGAAT|AGACTCAGCTTGTGAGGTGGTATAGACTAG
TGAACCTTGCTGAGGGAATGTTTGCACGTT|GAGAATCCTTTCCGGACTGCCTATGAGAAC
GTATACCCCGGACTTATGCGCAGATTGTGG|GGCGGGACAGGGACTGCAAACTCCTAGGCA
TTATCGCACCAGAGTGGCCTTTTACAGCTC|CCGGTCGGACAATCTCTGTAGTCTTTTCAT
CCCCATGTCGGAGTATACCCCGGACTTATG|GTTGCCCGAAAGGGCGGGACAGGGACTGCA
GACAATCTCTGTAGTCTTTTCATAGACACT|GAAAGGGCGAAATGTCACTGGGCGAATGAC
ATCAACGCGGTGCGTCCGTTTCGTTTAACG|GTAGGTGTGATAGTTTCCACCTAGCCACAG
GGTCGGTTAGAAAAGGGCACGTCGGCAGGG|CTGAGGGAATGTTTGCACGTTCTCGGATCA
GGCAGCCGTAAAATACAGCCCAAACAGCCA|GGCACGTCGGCAGGGTTGGGCACGTCGGCA
GGGTTGCCCGAAAGGGCGCCCGAAAGGGCG|ATTAGACTCAGCTTGTGAGGTGGTATAGAC
CGGCACGTCGGCAGGGTTGCCCGAAAGGGC|TACGGAACCCTGCGCGGCCGGCCGCCGATG
GACCCGTATGGTGGTACGATTGTTATCGCA|GGTTGCCCGAAAGGGCGCTAATCCGGTCGG
AATACAGCCCAAACAGCCATGCAGCGATAC|AGGGTTGGGCACGTCGGCAGGGTTGCCCGA
CGTCGGCAGGGTTGCCCGAAAGGCACGTCG|TGCAGCGATACTTACAAGGTTCCGAACACG
GTGGCACGTCGGCAGGGTTGCCCGAAAGGG|AAGGCCAAGAGGCACGTCGGCAGGGTTGCC
CCCGAAAGGGCGCCCGAAAGGGCGAATGGA|CTCAGCTTGTGAGGTGGTATAGACTAGCAC
GGGCGAATGACGAGAATCCTTTCCGGACTG|AGGTCTCCACGAACCTCGTCCTTAACCGAA
ACTTGAACCTTGCTGAGGGAATGTTTGCAC|GACGAGAATCCTTTCCGGACTGCCTATGAG
GTTGCCCGAAAGGGCGGGACAGGGACTGCA|GGCCGGCCGCCGATGGACGGAGAATGTGAT
CCCGAAAGGGCGGCATCGTTTTGACTTTGA|GGTTGCCCGAAAGGGCGAGTGGGCACGTCG
TCCTGATCCCCCATGTCGGAGTATACCCCG|TCGGCAGGGTTGCCCGAAAGGGCGGGACAG
CGGACTACAAATCCCGTAATTAGACTCAGC|ATGGTGGTACGATTGTTATCGCACCAGAGT
TTGGGCACGTCGGCAGGGTTGCCCGAAAGG|TCCAATTATAAGCCACTCCACCCTATGCGA
GTTATCGCACCAGAGTGGCCTTTTACAGCT|TCCGGTCGGACAATCTCTGTAGTCTTTTCA
GTAAAATACAGCCCAAACAGCCATGCAGCG|CGGCAGGGTTGGGCACGTCGGCAGGGTTGC
GGCACGTCGGCAGGGTTGCCCGAAAGGGCG|ATGTCGGAGTATACCCCGGACTTATGCGCA
CAGGGTTGCCCGAAAGGGCGCATTGAATAG|TCAGGAGCTTATTGTACAGTTTTTCGTAGC
TAGCACAAGCGTGATGTGGGTAAGGCACGT|AACGCCATAACTCGGTCGGTTAGAAAAGGG
CCCGAAAGGCACGTCGGCAGGGTTGCCCGA|CAAGGTTCCGAACACGCAACAACTCCGGCG
TAAAATACAGCCCAAACAGCCATGCAGCGA|GGCAGGGTTGGGCACGTCGGCAGGGTTGCC
GCGAAGCTTATAACTCATTAGTAGTCCAAT|CAAGTCAGCTAAAGCTTGCCGTATATACTT
TGGCGGGCCTGTTGGCACGTCGGCAGGGTT|CCCGAAAGGGCGGCATCGTTTTGACTTTGA
GAGGCACGTCGGCAGGGTTGCCCGAAAGGG|CCATGTCGGAGTATACCCCGGACTTATGCG
CCGAAAGGGCGGGACAGGGACTGCAAACTC|GCCGCCGATGGACGGAGAATGTGATGAATA
GAAAGGGCGTGGGCAGCCGTAAAATACAGC|ATGCGATTGATGGCACGTCGGCAGGGTTGG
TTGCCGTATATACTTTGGCGGGCCTGTTGG|ACGTCGGCAGGGTTGCCCGAAAGGGCGGCA
TCGGTCGGTTAGAAAAGGGCACGTCGGCAG|TGCTGAGGGAATGTTTGCACGTTCTCGGAT
TGAGTTAAAATGTGTGGCACGTCGGCAGGG|CCGAAAGGGCGAAAAGGCCAAGAGGCACGT
GCTTGGTCACTGCTCGGCACGTCGGCAGGG|CGTCGGCCACGATATACGGAACCCTGCGCG
CGGCACGTCGGCAGGGTTGCCCGAAAGGGC|TTGCCCGAAAGGGCGTGGGCAGCCGTAAAA
GAAAAGGCCAAGAGGCACGTCGGCAGGGTT|TACAGCCCAAACAGCCATGCAGCGATACTT
AGGGTTGCCCGAAAGGGCGGACTACAAATC|CTTTGAACGCGACCCGTATGGTGGTACGAT
AGGGCGTGACTCTCTTATTCGGGTCAGTTC|TGCCCGAAAGGCACGTCGGCAGGGTTGCCC
CGTGACTCTCTTATTCGGGTCAGTTCACAT|CGAAAGGCACGTCGGCAGGGTTGCCCGAAA
AGGGCACGTCGGCAGGGTTGCCCGAAAGGG|TGCACGTTCTCGGATCAACGCGGTGCGTCC
AGGGCGCTAATCCGGTCGGACAATCTCTGT|ACGTCGGCAGGGTTGCCCGAAAGGGCGAAA
ACTGCAAACTCCTAGGCACGTCGGCAGGGT|TGTGATGAATAGCTCAGGTGATCATCAGGA
CCTATGAGAACGGGTAGTAGGTGTGATAGT|GGCTGTTACCTGACTGAAAATATCGTGGCT
TCTCTTATTCGGGTCAGTTCACATGCTAGC|GCACGTCGGCAGGGTTGCCCGAAAGGGCGG
CACAAGCGTGATGTGGGTAAGGCACGTCGG|GCCATAACTCGGTCGGTTAGAAAAGGGCAC
GTGGTATAGACTAGCACAAGCGTGATGTGG|TACAGCTCCGCAACGCCATAACTCGGTCGG
TGTGAGGTGGTATAGACTAGCACAAGCGTG|GCCTTTTACAGCTCCGCAACGCCATAACTC
GCGCATTGAATAGGGCCTGTAGCGACTATT|AGTTTTTCGTAGCAGGTGCGTAAAAGTCGG
TGAGGTGGTATAGACTAGCACAAGCGTGAT|CTTTTACAGCTCCGCAACGCCATAACTCGG
TAGGCACGTCGGCAGGGTTGCCCGAAAGGG|CTCAGGTGATCATCAGGAGCTTATTGTACA
GACAGGGACTGCAAACTCCTAGGCACGTCG|CGGAGAATGTGATGAATAGCTCAGGTGATC
GGTACGATTGTTATCGCACCAGAGTGGCCT|GGGCGCTAATCCGGTCGGACAATCTCTGTA
GGGACAGGGACTGCAAACTCCTAGGCACGT|GACGGAGAATGTGATGAATAGCTCAGGTGA
TGCCGTATATACTTTGGCGGGCCTGTTGGC|CGTCGGCAGGGTTGCCCGAAAGGGCGGCAT
GAAATGTCACTGGGCGAATGACGAGAATCC|AGATTGTGGCTAGGTCTCCACGAACCTCGT
CAACTCCGGCGAAGCTTATAACTCATTAGT|GGATGTTGCAAGTCAGCTAAAGCTTGCCGT
CCCGTATGGTGGTACGATTGTTATCGCACC|TTGCCCGAAAGGGCGCTAATCCGGTCGGAC
AAGGCCAAGAGGCACGTCGGCAGGGTTGCC|AGCCCAAACAGCCATGCAGCGATACTTACA
CAATTATAAGCCACTCCACCCTATGCGATT|ACTTTGGCGGGCCTGTTGGCACGTCGGCAG
CACGTTCTCGGATCAACGCGGTGCGTCCGT|GAGAACGGGTAGTAGGTGTGATAGTTTCCA
AGTATACCCCGGACTTATGCGCAGATTGTG|GGGCGGGACAGGGACTGCAAACTCCTAGGC
AGCTTGCCGTATATACTTTGGCGGGCCTGT|GGCACGTCGGCAGGGTTGCCCGAAAGGGCG
ATGTGGGTAAGGCACGTCGGCAGGGTTGCC|GGTCGGTTAGAAAAGGGCACGTCGGCAGGG
ATTAGTAGTCCAATTATAAGCCACTCCACC|TGCCGTATATACTTTGGCGGGCCTGTTGGC
GGCAGGGTTGCCCGAAAGGGCGAGTGGGCA|CGGATCAACGCGGTGCGTCCGTTTCGTTTA
CCCATGTCGGAGTATACCCCGGACTTATGC|TTGCCCGAAAGGGCGGGACAGGGACTGCAA
AACCTCGTCCTTAACCGAAGGCTGTTACCT|GCCCGAAAGGGCGCATTGAATAGGGCCTGT
CACGTCGGCAGGGTTGCCCGAAAGGCACGT|CATGCAGCGATACTTACAAGGTTCCGAACA
TATAAGCCACTCCACCCTATGCGATTGATG|TGGCGGGCCTGTTGGCACGTCGGCAGGGTT
GGACTGCCTATGAGAACGGGTAGTAGGTGT|ACCGAAGGCTGTTACCTGACTGAAAATATC
AAAATACAGCCCAAACAGCCATGCAGCGAT|GCAGGGTTGGGCACGTCGGCAGGGTTGCCC
AGGGAATGTTTGCACGTTCTCGGATCAACG|CGGACTGCCTATGAGAACGGGTAGTAGGTG
CAACGCGGTGCGTCCGTTTCGTTTAACGGG|AGGTGTGATAGTTTCCACCTAGCCACAGCT
GCAGGGTTGCCCGAAAGGGCGAAAAGGCCA|GGGCGTGGGCAGCCGTAAAATACAGCCCAA
TTACAGCTCCGCAACGCCATAACTCGGTCG|TCTTTTCATAGACACTTGAACCTTGCTGAG
TCGGTTAGAAAAGGGCACGTCGGCAGGGTT|GAGGGAATGTTTGCACGTTCTCGGATCAAC
AGCCAAATTATCATGGCGGGTCAACAGACA|CGGGGCGCTATCGAGTTTGGGCACGTCGGC
TGGTCACTGCTCGGCACGTCGGCAGGGTTG|CGGCCACGATATACGGAACCCTGCGCGGCC
AGATTGTGGCTAGGTCTCCACGAACCTCGT|TCCTAGGCACGTCGGCAGGGTTGCCCGAAA
CGTAATTAGACTCAGCTTGTGAGGTGGTAT|GTTATCGCACCAGAGTGGCCTTTTACAGCT
AACCGAAGGCTGTTACCTGACTGAAAATAT|GCATTGAATAGGGCCTGTAGCGACTATTCC
GTAGTAGGTGTGATAGTTTCCACCTAGCCA|CTGAAAATATCGTGGCTTGGTCACTGCTCG
TTCCGAACACGCAACAACTCCGGCGAAGCT|CCGAAAGGGCGAATGGATGTTGCAAGTCAG
AGGGCGGGACAGGGACTGCAAACTCCTAGG|CGATGGACGGAGAATGTGATGAATAGCTCA
AAGGGCGCATTGAATAGGGCCTGTAGCGAC|GTACAGTTTTTCGTAGCAGGTGCGTAAAAG
GCCCGAAAGGGCGAGTGGGCACGTCGGCAG|GCGGTGCGTCCGTTTCGTTTAACGGGTTTC
ACAAATCCCGTAATTAGACTCAGCTTGTGA|GTACGATTGTTATCGCACCAGAGTGGCCTT
GCACGTCGGCAGGGTTGCCCGAAAGGGCGG|CGAACACGCAACAACTCCGGCGAAGCTTAT
CGAAGGCTGTTACCTGACTGAAAATATCGT|TTGAATAGGGCCTGTAGCGACTATTCCCTC
CGGCAGGGTTGCCCGAAAGGGCGAAATGTC|AGTATACCCCGGACTTATGCGCAGATTGTG
ATCCTTTCCGGACTGCCTATGAGAACGGGT|TCGTCCTTAACCGAAGGCTGTTACCTGACT
TGCCCGAAAGGGCGGGGCGCTATCGAGTTT|TCCGGCGAAGCTTATAACTCATTAGTAGTC
AGCTTGTGAGGTGGTATAGACTAGCACAAG|AGTGGCCTTTTACAGCTCCGCAACGCCATA
ACTCCACCCTATGCGATTGATGGCACGTCG|CTGTTGGCACGTCGGCAGGGTTGCCCGAAA
ATTATAAGCCACTCCACCCTATGCGATTGA|TTTGGCGGGCCTGTTGGCACGTCGGCAGGG
TCGGCAGGGTTGCCCGAAAGGGCGAAAAGG|AAAGGGCGTGGGCAGCCGTAAAATACAGCC
GGGGCGCTATCGAGTTTGGGCACGTCGGCA|ATAACTCATTAGTAGTCCAATTATAAGCCA
AGGGTTGCCCGAAAGGGCGAAAAGGCCAAG|GCGTGGGCAGCCGTAAAATACAGCCCAAAC
AATGTTTGCACGTTCTCGGATCAACGCGGT|CTGCCTATGAGAACGGGTAGTAGGTGTGAT
GTTGCCCGAAAGGGCGTGGGCAGCCGTAAA|CCACCCTATGCGATTGATGGCACGTCGGCA
CACCCTATGCGATTGATGGCACGTCGGCAG|TGGCACGTCGGCAGGGTTGCCCGAAAGGGC
AAGGGCGGACTACAAATCCCGTAATTAGAC|CCCGTATGGTGGTACGATTGTTATCGCACC
CAGGGTTGCCCGAAAGGGCGAGTGGGCACG|GATCAACGCGGTGCGTCCGTTTCGTTTAAC
TGCACGTTCTCGGATCAACGCGGTGCGTCC|ATGAGAACGGGTAGTAGGTGTGATAGTTTC
CACGTCGGCAGGGTTGCCCGAAAGGGCGCT|TAACGGGTTTCGGGAGGGAGGCACGTCGGC
ATGCAGCGATACTTACAAGGTTCCGAACAC|AGGGTTGCCCGAAAGGGCGCCCGAAAGGGC
CACGCAACAACTCCGGCGAAGCTTATAACT|GGCGAATGGATGTTGCAAGTCAGCTAAAGC
GTATGGTGGTACGATTGTTATCGCACCAGA|CCCGAAAGGGCGCTAATCCGGTCGGACAAT
GGGCGCATTGAATAGGGCCTGTAGCGACTA|ACAGTTTTTCGTAGCAGGTGCGTAAAAGTC
CCGTATATACTTTGGCGGGCCTGTTGGCAC|TCGGCAGGGTTGCCCGAAAGGGCGGCATCG
CAGGGTTGCCCGAAAGGGCGTGACTCTCTT|CACGTCGGCAGGGTTGCCCGAAAGGCACGT
TCGGCAGGGTTGGGCACGTCGGCAGGGTTG|AAAGGGCGGACTACAAATCCCGTAATTAGA
GGGTTGCCCGAAAGGGCGGACTACAAATCC|TTTGAACGCGACCCGTATGGTGGTACGATT
TACCCCGGACTTATGCGCAGATTGTGGCTA|GGGACAGGGACTGCAAACTCCTAGGCACGT
ACGGGTTTCGGGAGGGAGGCACGTCGGCAG|CAGCTTCCTGATCCCCCATGTCGGAGTATA
ATGCGCAGATTGTGGCTAGGTCTCCACGAA|GCAAACTCCTAGGCACGTCGGCAGGGTTGC
CCGAACACGCAACAACTCCGGCGAAGCTTA|GAAAGGGCGAATGGATGTTGCAAGTCAGCT
GCGGGCCTGTTGGCACGTCGGCAGGGTTGC|CGAAAGGGCGGCATCGTTTTGACTTTGAAC
AAAAGGGCACGTCGGCAGGGTTGCCCGAAA|GTTTGCACGTTCTCGGATCAACGCGGTGCG
CGCTAATCCGGTCGGACAATCTCTGTAGTC|CGGCAGGGTTGCCCGAAAGGGCGAAATGTC
GGTCACTGCTCGGCACGTCGGCAGGGTTGC|GGCCACGATATACGGAACCCTGCGCGGCCG
AGTAGTCCAATTATAAGCCACTCCACCCTA|CGTATATACTTTGGCGGGCCTGTTGGCACG
CTCATTAGTAGTCCAATTATAAGCCACTCC|GCTTGCCGTATATACTTTGGCGGGCCTGTT
TCCACGAACCTCGTCCTTAACCGAAGGCTG|AGGGTTGCCCGAAAGGGCGCATTGAATAGG
GGGCGGGGCGCTATCGAGTTTGGGCACGTC|GCTTATAACTCATTAGTAGTCCAATTATAA
GTCGGCAGGGTTGCCCGAAAGGGCGAGTGG|TCTCGGATCAACGCGGTGCGTCCGTTTCGT
ATGTCGGAGTATACCCCGGACTTATGCGCA|CCCGAAAGGGCGGGACAGGGACTGCAAACT
AACTCGGTCGGTTAGAAAAGGGCACGTCGG|CCTTGCTGAGGGAATGTTTGCACGTTCTCG
CCGGCACGTCGGCAGGGTTGCCCGAAAGGG|GTTGCCCGAAAGGGCGTGGGCAGCCGTAAA
TTTGGGCACGTCGGCAGGGTTGCCCGAAAG|GTCCAATTATAAGCCACTCCACCCTATGCG
TAACCGAAGGCTGTTACCTGACTGAAAATA|CGCATTGAATAGGGCCTGTAGCGACTATTC
TGCCCGAAAGGGCGCATTGAATAGGGCCTG|GCTTATTGTACAGTTTTTCGTAGCAGGTGC
CCCGTCGGCCACGATATACGGAACCCTGCG|TCGGCAGGGTTGCCCGAAAGGGCGTCGGTT
GTTACCTGACTGAAAATATCGTGGCTTGGT|GGCCTGTAGCGACTATTCCCTCCCGTCGGC
GGCGAAGCTTATAACTCATTAGTAGTCCAA|GCAAGTCAGCTAAAGCTTGCCGTATATACT
CACTTGAACCTTGCTGAGGGAATGTTTGCA|TGACGAGAATCCTTTCCGGACTGCCTATGA
TCCCGTAATTAGACTCAGCTTGTGAGGTGG|ATTGTTATCGCACCAGAGTGGCCTTTTACA
CTAGCCAAATTATCATGGCGGGTCAACAGA|GGCGGGGCGCTATCGAGTTTGGGCACGTCG
TATAGACTAGCACAAGCGTGATGTGGGTAA|GCTCCGCAACGCCATAACTCGGTCGGTTAG
TTGTGAGGTGGTATAGACTAGCACAAGCGT|GGCCTTTTACAGCTCCGCAACGCCATAACT
AAAGGGCGGCATCGTTTTGACTTTGAACGC|GCCCGAAAGGGCGAGTGGGCACGTCGGCAG
TATGGTGGTACGATTGTTATCGCACCAGAG|CCGAAAGGGCGCTAATCCGGTCGGACAATC
AGCTAAAGCTTGCCGTATATACTTTGGCGG|GGGTAAGGCACGTCGGCAGGGTTGCCCGAA
CCCGAAAGGGCGTGACTCTCTTATTCGGGT|CAGGGTTGCCCGAAAGGCACGTCGGCAGGG
TGCGTCCGTTTCGTTTAACGGGTTTCGGGA|TAGTTTCCACCTAGCCACAGCTTCCTGATC
AGGCACGTCGGCAGGGTTGCCCGAAAGGGC|CATGTCGGAGTATACCCCGGACTTATGCGC
TTTGAACGCGACCCGTATGGTGGTACGATT|CGTCGGCAGGGTTGCCCGAAAGGGCGCTAA
CCCGAAAGGGCGAATGGATGTTGCAAGTCA|GGTGGTATAGACTAGCACAAGCGTGATGTG
GCGCTATCGAGTTTGGGCACGTCGGCAGGG|ACTCATTAGTAGTCCAATTATAAGCCACTC
TTGTTATCGCACCAGAGTGGCCTTTTACAG|AATCCGGTCGGACAATCTCTGTAGTCTTTT
GCACGTCGGCAGGGTTGCCCGAAAGGGCGA|ACGTTCTCGGATCAACGCGGTGCGTCCGTT
AATGTGTGGCACGTCGGCAGGGTTGCCCGA|GCGAAAAGGCCAAGAGGCACGTCGGCAGGG
GTTGCCCGAAAGGGCGCTAATCCGGTCGGA|GGAGGGAGGCACGTCGGCAGGGTTGCCCGA
ATTCCCTCCCGTCGGCCACGATATACGGAA|CGGCACGTCGGCAGGGTTGCCCGAAAGGGC
TTGCCCGAAAGGGCGTGGGCAGCCGTAAAA|CACCCTATGCGATTGATGGCACGTCGGCAG
CTCTTATTCGGGTCAGTTCACATGCTAGCC|CACGTCGGCAGGGTTGCCCGAAAGGGCGGG
GAGGTGGTATAGACTAGCACAAGCGTGATG|TTTTACAGCTCCGCAACGCCATAACTCGGT
CTAGGTCTCCACGAACCTCGTCCTTAACCG|CGTCGGCAGGGTTGCCCGAAAGGGCGCATT
CAGGGTTGCCCGAAAGGGCGCTAATCCGGT|TTCGGGAGGGAGGCACGTCGGCAGGGTTGC
AGACATGACCGGCACGTCGGCAGGGTTGCC|TCGGCAGGGTTGCCCGAAAGGGCGTGGGCA
TGAAAATATCGTGGCTTGGTCACTGCTCGG|GACTATTCCCTCCCGTCGGCCACGATATAC
GCTTGTGAGGTGGTATAGACTAGCACAAGC|GTGGCCTTTTACAGCTCCGCAACGCCATAA
CGATACTTACAAGGTTCCGAACACGCAACA|GCCCGAAAGGGCGCCCGAAAGGGCGAATGG
GAATAGGGCCTGTAGCGACTATTCCCTCCC|CGTAGCAGGTGCGTAAAAGTCGGCACGTCG
TGACTGAAAATATCGTGGCTTGGTCACTGC|TAGCGACTATTCCCTCCCGTCGGCCACGAT
GGGAGGGAGGCACGTCGGCAGGGTTGCCCG|GATCCCCCATGTCGGAGTATACCCCGGACT
TGGCTTGGTCACTGCTCGGCACGTCGGCAG|CCCGTCGGCCACGATATACGGAACCCTGCG
CCACCCTATGCGATTGATGGCACGTCGGCA|TTGGCACGTCGGCAGGGTTGCCCGAAAGGG
CGAGTTTGGGCACGTCGGCAGGGTTGCCCG|AGTAGTCCAATTATAAGCCACTCCACCCTA
TTGCTGAGGGAATGTTTGCACGTTCTCGGA|CCTTTCCGGACTGCCTATGAGAACGGGTAG
CCGAAAGGGCGAAAAGGCCAAGAGGCACGT|AGCCGTAAAATACAGCCCAAACAGCCATGC
TGCCCGAAAGGGCGGACTACAAATCCCGTA|AACGCGACCCGTATGGTGGTACGATTGTTA
ATGCGATTGATGGCACGTCGGCAGGGTTGG|GTCGGCAGGGTTGCCCGAAAGGGCGGACTA
GGCAGGGTTGCCCGAAAGGGCGGACTACAA|TGACTTTGAACGCGACCCGTATGGTGGTAC
GAACACGCAACAACTCCGGCGAAGCTTATA|AAGGGCGAATGGATGTTGCAAGTCAGCTAA
GAGTGGCCTTTTACAGCTCCGCAACGCCAT|ATCTCTGTAGTCTTTTCATAGACACTTGAA
ATCATGGCGGGTCAACAGACATGACCGGCA|ATCGAGTTTGGGCACGTCGGCAGGGTTGCC
CGTCGGCAGGGTTGGGCACGTCGGCAGGGT|CGAAAGGGCGGACTACAAATCCCGTAATTA
TGGCCTTTTACAGCTCCGCAACGCCATAAC|TCTGTAGTCTTTTCATAGACACTTGAACCT
CACGTCGGCAGGGTTGGGCACGTCGGCAGG|CCCGAAAGGGCGGACTACAAATCCCGTAAT
CTACAAATCCCGTAATTAGACTCAGCTTGT|TGGTACGATTGTTATCGCACCAGAGTGGCC
AGCTTATAACTCATTAGTAGTCCAATTATA|TCAGCTAAAGCTTGCCGTATATACTTTGGC
GGTAAGGCACGTCGGCAGGGTTGCCCGAAA|GTTAGAAAAGGGCACGTCGGCAGGGTTGCC
GTTCTCGGATCAACGCGGTGCGTCCGTTTC|AACGGGTAGTAGGTGTGATAGTTTCCACCT
GCACGTCGGCAGGGTTGCCCGAAAGGGCGG|ATCGTTTTGACTTTGAACGCGACCCGTATG
ACATGCTAGCCAAATTATCATGGCGGGTCA|GAAAGGGCGGGGCGCTATCGAGTTTGGGCA
TTAAAATGTGTGGCACGTCGGCAGGGTTGC|AAGGGCGAAAAGGCCAAGAGGCACGTCGGC
TTTCCGGACTGCCTATGAGAACGGGTAGTA|CCTTAACCGAAGGCTGTTACCTGACTGAAA
ACGCGACCCGTATGGTGGTACGATTGTTAT|GCAGGGTTGCCCGAAAGGGCGCTAATCCGG
GGCGGACTACAAATCCCGTAATTAGACTCA|GTATGGTGGTACGATTGTTATCGCACCAGA
GGTTGCCCGAAAGGGCGGCATCGTTTTGAC|GGCAGGGTTGCCCGAAAGGGCGAGTGGGCA
CGGCAGGGTTGCCCGAAAGGGCGCATTGAA|TCATCAGGAGCTTATTGTACAGTTTTTCGT
ACTAGCACAAGCGTGATGTGGGTAAGGCAC|GCAACGCCATAACTCGGTCGGTTAGAAAAG
CGATATACGGAACCCTGCGCGGCCGGCCGC|GCCCGAAAGGGCGTCGGTTTAATGCTGCCA
AGGCTGTTACCTGACTGAAAATATCGTGGC|AATAGGGCCTGTAGCGACTATTCCCTCCCG
GGGCCTGTAGCGACTATTCCCTCCCGTCGG|CAGGTGCGTAAAAGTCGGCACGTCGGCAGG
TGCAAGTCAGCTAAAGCTTGCCGTATATAC|CGTGATGTGGGTAAGGCACGTCGGCAGGGT
GGGTCAGTTCACATGCTAGCCAAATTATCA|AGGGTTGCCCGAAAGGGCGGGGCGCTATCG
GCCCGAAAGGGCGGGACAGGGACTGCAAAC|CGGCCGCCGATGGACGGAGAATGTGATGAA
TACCTGACTGAAAATATCGTGGCTTGGTCA|CCTGTAGCGACTATTCCCTCCCGTCGGCCA
AGGGCGGCATCGTTTTGACTTTGAACGCGA|CCGAAAGGGCGAGTGGGCACGTCGGCAGGG
TCTCGGATCAACGCGGTGCGTCCGTTTCGT|CGGGTAGTAGGTGTGATAGTTTCCACCTAG
CCTGACTGAAAATATCGTGGCTTGGTCACT|TGTAGCGACTATTCCCTCCCGTCGGCCACG
AAAATATCGTGGCTTGGTCACTGCTCGGCA|CTATTCCCTCCCGTCGGCCACGATATACGG
GCTATCGAGTTTGGGCACGTCGGCAGGGTT|TCATTAGTAGTCCAATTATAAGCCACTCCA
GCGACCCGTATGGTGGTACGATTGTTATCG|AGGGTTGCCCGAAAGGGCGCTAATCCGGTC
CCAAATTATCATGGCGGGTCAACAGACATG|GGGCGCTATCGAGTTTGGGCACGTCGGCAG
CGGCAGGGTTGCCCGAAAGGGCGGGGCGCT|CGCAACAACTCCGGCGAAGCTTATAACTCA
GACATGACCGGCACGTCGGCAGGGTTGCCC|CGGCAGGGTTGCCCGAAAGGGCGTGGGCAG
CGGACTTATGCGCAGATTGTGGCTAGGTCT|AGGGACTGCAAACTCCTAGGCACGTCGGCA
TCGGGTCAGTTCACATGCTAGCCAAATTAT|GCAGGGTTGCCCGAAAGGGCGGGGCGCTAT
AAGGGCGGCATCGTTTTGACTTTGAACGCG|CCCGAAAGGGCGAGTGGGCACGTCGGCAGG
GGCACGTCGGCAGGGTTGCCCGAAAGGGCG|TTTAACGGGTTTCGGGAGGGAGGCACGTCG
TTCACATGCTAGCCAAATTATCATGGCGGG|CCCGAAAGGGCGGGGCGCTATCGAGTTTGG
CGACTATTCCCTCCCGTCGGCCACGATATA|AAAGTCGGCACGTCGGCAGGGTTGCCCGAA
TAGTAGTCCAATTATAAGCCACTCCACCCT|CCGTATATACTTTGGCGGGCCTGTTGGCAC
GCTAGCCAAATTATCATGGCGGGTCAACAG|GGGCGGGGCGCTATCGAGTTTGGGCACGTC
CTCCTAGGCACGTCGGCAGGGTTGCCCGAA|ATAGCTCAGGTGATCATCAGGAGCTTATTG
GCGTGGGCAGCCGTAAAATACAGCCCAAAC|TTGATGGCACGTCGGCAGGGTTGGGCACGT
GCCCGAAAGGGCGCATTGAATAGGGCCTGT|CTTATTGTACAGTTTTTCGTAGCAGGTGCG
AAGGGCGCTAATCCGGTCGGACAATCTCTG|CACGTCGGCAGGGTTGCCCGAAAGGGCGAA
GTTAGAAAAGGGCACGTCGGCAGGGTTGCC|GGAATGTTTGCACGTTCTCGGATCAACGCG
TGGCGGGTCAACAGACATGACCGGCACGTC|AGTTTGGGCACGTCGGCAGGGTTGCCCGAA
TTCCTGATCCCCCATGTCGGAGTATACCCC|GTCGGCAGGGTTGCCCGAAAGGGCGGGACA
GGCAGGGTTGCCCGAAAGGGCGAAAAGGCC|AGGGCGTGGGCAGCCGTAAAATACAGCCCA
GGTTGCCCGAAAGGGCGGACTACAAATCCC|TTGAACGCGACCCGTATGGTGGTACGATTG
GAAAGGGCGAAATGTCACTGGGCGAATGAC|TTATGCGCAGATTGTGGCTAGGTCTCCACG
CAAATCCCGTAATTAGACTCAGCTTGTGAG|TACGATTGTTATCGCACCAGAGTGGCCTTT
GCGGACTACAAATCCCGTAATTAGACTCAG|TATGGTGGTACGATTGTTATCGCACCAGAG
ATGGTGGTACGATTGTTATCGCACCAGAGT|CGAAAGGGCGCTAATCCGGTCGGACAATCT
GCAGGGTTGCCCGAAAGGGCGGGGCGCTAT|CAACAACTCCGGCGAAGCTTATAACTCATT
ATTGTGGCTAGGTCTCCACGAACCTCGTCC|CTAGGCACGTCGGCAGGGTTGCCCGAAAGG
TCGGGAGGGAGGCACGTCGGCAGGGTTGCC|CTGATCCCCCATGTCGGAGTATACCCCGGA
ATGACCGGCACGTCGGCAGGGTTGCCCGAA|CAGGGTTGCCCGAAAGGGCGTGGGCAGCCG
ATGACGAGAATCCTTTCCGGACTGCCTATG|CCACGAACCTCGTCCTTAACCGAAGGCTGT
TCCGGACTGCCTATGAGAACGGGTAGTAGG|TTAACCGAAGGCTGTTACCTGACTGAAAAT
CCGAAAGGGCGTGGGCAGCCGTAAAATACA|CTATGCGATTGATGGCACGTCGGCAGGGTT
TTTTCATAGACACTTGAACCTTGCTGAGGG|ACTGGGCGAATGACGAGAATCCTTTCCGGA
CGGTCGGTTAGAAAAGGGCACGTCGGCAGG|GCTGAGGGAATGTTTGCACGTTCTCGGATC
ACTCCTAGGCACGTCGGCAGGGTTGCCCGA|AATAGCTCAGGTGATCATCAGGAGCTTATT
AGCGATACTTACAAGGTTCCGAACACGCAA|TTGCCCGAAAGGGCGCCCGAAAGGGCGAAT
CTCCCGTCGGCCACGATATACGGAACCCTG|CGTCGGCAGGGTTGCCCGAAAGGGCGTCGG
GGGTTGCCCGAAAGGGCGTGGGCAGCCGTA|CTCCACCCTATGCGATTGATGGCACGTCGG
GAAGCTTATAACTCATTAGTAGTCCAATTA|AGTCAGCTAAAGCTTGCCGTATATACTTTG
ATATCGTGGCTTGGTCACTGCTCGGCACGT|TTCCCTCCCGTCGGCCACGATATACGGAAC
AAATACAGCCCAAACAGCCATGCAGCGATA|CAGGGTTGGGCACGTCGGCAGGGTTGCCCG
ATACTTACAAGGTTCCGAACACGCAACAAC|CCGAAAGGGCGCCCGAAAGGGCGAATGGAT
TGCCTATGAGAACGGGTAGTAGGTGTGATA|AAGGCTGTTACCTGACTGAAAATATCGTGG
AGGGTTGCCCGAAAGGGCGCTAATCCGGTC|TCGGGAGGGAGGCACGTCGGCAGGGTTGCC
ACGTCGGCAGGGTTGCCCGAAAGGCACGTC|ATGCAGCGATACTTACAAGGTTCCGAACAC
TTTTGACTTTGAACGCGACCCGTATGGTGG|GTGGGCACGTCGGCAGGGTTGCCCGAAAGG
GCCCAAACAGCCATGCAGCGATACTTACAA|GGGCACGTCGGCAGGGTTGCCCGAAAGGGC
TGCCCGAAAGGCACGTCGGCAGGGTTGCCC|TACAAGGTTCCGAACACGCAACAACTCCGG
AACACGCAACAACTCCGGCGAAGCTTATAA|AGGGCGAATGGATGTTGCAAGTCAGCTAAA
GCTAATCCGGTCGGACAATCTCTGTAGTCT|GGCAGGGTTGCCCGAAAGGGCGAAATGTCA
TTCATAGACACTTGAACCTTGCTGAGGGAA|TGGGCGAATGACGAGAATCCTTTCCGGACT
TTGTGGCTAGGTCTCCACGAACCTCGTCCT|TAGGCACGTCGGCAGGGTTGCCCGAAAGGG
TTGGGCACGTCGGCAGGGTTGCCCGAAAGG|ACTACAAATCCCGTAATTAGACTCAGCTTG
CCGAAAGGGCGCCCGAAAGGGCGAATGGAT|TCAGCTTGTGAGGTGGTATAGACTAGCACA
AATGACGAGAATCCTTTCCGGACTGCCTAT|TCCACGAACCTCGTCCTTAACCGAAGGCTG
GAAAGGGCGGGGCGCTATCGAGTTTGGGCA|CGAAGCTTATAACTCATTAGTAGTCCAATT
TGACGAGAATCCTTTCCGGACTGCCTATGA|CACGAACCTCGTCCTTAACCGAAGGCTGTT
GGCGAAATGTCACTGGGCGAATGACGAGAA|CGCAGATTGTGGCTAGGTCTCCACGAACCT
CCTTTCCGGACTGCCTATGAGAACGGGTAG|GTCCTTAACCGAAGGCTGTTACCTGACTGA
CTAGCACAAGCGTGATGTGGGTAAGGCACG|CAACGCCATAACTCGGTCGGTTAGAAAAGG
CCAAACAGCCATGCAGCGATACTTACAAGG|GCACGTCGGCAGGGTTGCCCGAAAGGGCGC
CGGTTAGAAAAGGGCACGTCGGCAGGGTTG|AGGGAATGTTTGCACGTTCTCGGATCAACG
GCAACGCCATAACTCGGTCGGTTAGAAAAG|GACACTTGAACCTTGCTGAGGGAATGTTTG
GGACTGCAAACTCCTAGGCACGTCGGCAGG|AATGTGATGAATAGCTCAGGTGATCATCAG
CGATTGTTATCGCACCAGAGTGGCCTTTTA|GCTAATCCGGTCGGACAATCTCTGTAGTCT
GAAAGGGCGCATTGAATAGGGCCTGTAGCG|TTGTACAGTTTTTCGTAGCAGGTGCGTAAA
AAAGGGCGTGACTCTCTTATTCGGGTCAGT|GTTGCCCGAAAGGCACGTCGGCAGGGTTGC
TATGCGATTGATGGCACGTCGGCAGGGTTG|CGTCGGCAGGGTTGCCCGAAAGGGCGGACT
GCGAAAAGGCCAAGAGGCACGTCGGCAGGG|AATACAGCCCAAACAGCCATGCAGCGATAC
GGCACGTCGGCAGGGTTGCCCGAAAGGGCG|CATCGTTTTGACTTTGAACGCGACCCGTAT
TTGCCCGAAAGGGCGTGACTCTCTTATTCG|CGGCAGGGTTGCCCGAAAGGCACGTCGGCA
GGCAGGGTTGCCCGAAAGGGCGAAATGTCA|GTATACCCCGGACTTATGCGCAGATTGTGG
CTGCAAACTCCTAGGCACGTCGGCAGGGTT|GTGATGAATAGCTCAGGTGATCATCAGGAG
TCGGCAGGGTTGCCCGAAAGGGCGGACTAC|TTTGACTTTGAACGCGACCCGTATGGTGGT
GTCACTGCTCGGCACGTCGGCAGGGTTGCC|GCCACGATATACGGAACCCTGCGCGGCCGG
CACGTCGGCAGGGTTGCCCGAAAGGGCGGC|AAGGGCACGTCGGCAGGGTTGCCCGAAAGG
AAAATGTGTGGCACGTCGGCAGGGTTGCCC|GGGCGAAAAGGCCAAGAGGCACGTCGGCAG
GTCCAATTATAAGCCACTCCACCCTATGCG|TATACTTTGGCGGGCCTGTTGGCACGTCGG
CCGAAAGGCACGTCGGCAGGGTTGCCCGAA|AAGGTTCCGAACACGCAACAACTCCGGCGA
TTTCGTTTAACGGGTTTCGGGAGGGAGGCA|ACCTAGCCACAGCTTCCTGATCCCCCATGT
TGCCCGAAAGGGCGTGGGCAGCCGTAAAAT|ACCCTATGCGATTGATGGCACGTCGGCAGG
GGGCAGCCGTAAAATACAGCCCAAACAGCC|TGGCACGTCGGCAGGGTTGGGCACGTCGGC
TTCTCGGATCAACGCGGTGCGTCCGTTTCG|ACGGGTAGTAGGTGTGATAGTTTCCACCTA
CGAAAGGGCGCATTGAATAGGGCCTGTAGC|ATTGTACAGTTTTTCGTAGCAGGTGCGTAA
GAAAGGGCGTGACTCTCTTATTCGGGTCAG|GGTTGCCCGAAAGGCACGTCGGCAGGGTTG
ATGTGTGGCACGTCGGCAGGGTTGCCCGAA|CGAAAAGGCCAAGAGGCACGTCGGCAGGGT
CTTATGCGCAGATTGTGGCTAGGTCTCCAC|ACTGCAAACTCCTAGGCACGTCGGCAGGGT
CGAAATGTCACTGGGCGAATGACGAGAATC|CAGATTGTGGCTAGGTCTCCACGAACCTCG
ACCTAGCCACAGCTTCCTGATCCCCCATGT|CACTGCTCGGCACGTCGGCAGGGTTGCCCG
CACCTAGCCACAGCTTCCTGATCCCCCATG|TCACTGCTCGGCACGTCGGCAGGGTTGCCC
CGAAAGGGCGGCATCGTTTTGACTTTGAAC|TTGCCCGAAAGGGCGAGTGGGCACGTCGGC
CTTTTCATAGACACTTGAACCTTGCTGAGG|CACTGGGCGAATGACGAGAATCCTTTCCGG
ACGAACCTCGTCCTTAACCGAAGGCTGTTA|GTTGCCCGAAAGGGCGCATTGAATAGGGCC
GGTTGCCCGAAAGGGCGCATTGAATAGGGC|GGAGCTTATTGTACAGTTTTTCGTAGCAGG
CCTTTTACAGCTCCGCAACGCCATAACTCG|GTAGTCTTTTCATAGACACTTGAACCTTGC
GTCGGAGTATACCCCGGACTTATGCGCAGA|CGAAAGGGCGGGACAGGGACTGCAAACTCC
GGCACGTCGGCAGGGTTGCCCGAAAGGGCG|ACGGAACCCTGCGCGGCCGGCCGCCGATGG
AGCCCAAACAGCCATGCAGCGATACTTACA|TGGGCACGTCGGCAGGGTTGCCCGAAAGGG
AGTTTGGGCACGTCGGCAGGGTTGCCCGAA|TAGTCCAATTATAAGCCACTCCACCCTATG
TAAGCCACTCCACCCTATGCGATTGATGGC|GCGGGCCTGTTGGCACGTCGGCAGGGTTGC
CTTGGTCACTGCTCGGCACGTCGGCAGGGT|GTCGGCCACGATATACGGAACCCTGCGCGG
TTGCCCGAAAGGGCGAAAAGGCCAAGAGGC|GGGCAGCCGTAAAATACAGCCCAAACAGCC
GTCTCCACGAACCTCGTCCTTAACCGAAGG|GGCAGGGTTGCCCGAAAGGGCGCATTGAAT
GAATGGATGTTGCAAGTCAGCTAAAGCTTG|CTAGCACAAGCGTGATGTGGGTAAGGCACG
ACCAGAGTGGCCTTTTACAGCTCCGCAACG|GACAATCTCTGTAGTCTTTTCATAGACACT
TGTTATCGCACCAGAGTGGCCTTTTACAGC|ATCCGGTCGGACAATCTCTGTAGTCTTTTC
CACATGCTAGCCAAATTATCATGGCGGGTC|CGAAAGGGCGGGGCGCTATCGAGTTTGGGC
GAAAGGCACGTCGGCAGGGTTGCCCGAAAG|GGTTCCGAACACGCAACAACTCCGGCGAAG
CGGCAGGGTTGCCCGAAAGGGCGCTAATCC|GGTTTCGGGAGGGAGGCACGTCGGCAGGGT
GCCATAACTCGGTCGGTTAGAAAAGGGCAC|TTGAACCTTGCTGAGGGAATGTTTGCACGT
GGGCGAAAAGGCCAAGAGGCACGTCGGCAG|AAAATACAGCCCAAACAGCCATGCAGCGAT
TTTGACTTTGAACGCGACCCGTATGGTGGT|TGGGCACGTCGGCAGGGTTGCCCGAAAGGG
GGCACGTCGGCAGGGTTGGGCACGTCGGCA|TGCCCGAAAGGGCGGACTACAAATCCCGTA
TGCAGCGATACTTACAAGGTTCCGAACACG|GGGTTGCCCGAAAGGGCGCCCGAAAGGGCG
GAAAGGGCGGGACAGGGACTGCAAACTCCT|CGCCGATGGACGGAGAATGTGATGAATAGC
GGTTGCCCGAAAGGGCGCTAATCCGGTCGG|GGGAGGGAGGCACGTCGGCAGGGTTGCCCG
TTGATGGCACGTCGGCAGGGTTGGGCACGT|AGGGTTGCCCGAAAGGGCGGACTACAAATC
GGGCGTGACTCTCTTATTCGGGTCAGTTCA|GCCCGAAAGGCACGTCGGCAGGGTTGCCCG
CGGCAGGGTTGCCCGAAAGGGCGAAAAGGC|AAGGGCGTGGGCAGCCGTAAAATACAGCCC
TCGGCAGGGTTGCCCGAAAGGGCGAGTGGG|CTCGGATCAACGCGGTGCGTCCGTTTCGTT
CGAACCTCGTCCTTAACCGAAGGCTGTTAC|TTGCCCGAAAGGGCGCATTGAATAGGGCCT
AACTCATTAGTAGTCCAATTATAAGCCACT|AAGCTTGCCGTATATACTTTGGCGGGCCTG
GCCCGAAAGGGCGAAATGTCACTGGGCGAA|GGACTTATGCGCAGATTGTGGCTAGGTCTC
CAGGGTTGCCCGAAAGGGCGAAATGTCACT|ATACCCCGGACTTATGCGCAGATTGTGGCT
AAGGGCGAAATGTCACTGGGCGAATGACGA|ATGCGCAGATTGTGGCTAGGTCTCCACGAA
CTCTGTAGTCTTTTCATAGACACTTGAACC|GCGAAATGTCACTGGGCGAATGACGAGAAT
CGCAACAACTCCGGCGAAGCTTATAACTCA|CGAATGGATGTTGCAAGTCAGCTAAAGCTT
CCCGAAAGGGCGAAATGTCACTGGGCGAAT|GACTTATGCGCAGATTGTGGCTAGGTCTCC
TTCCCTCCCGTCGGCCACGATATACGGAAC|GGCACGTCGGCAGGGTTGCCCGAAAGGGCG
GCAAACTCCTAGGCACGTCGGCAGGGTTGC|GATGAATAGCTCAGGTGATCATCAGGAGCT
GTTTGGGCACGTCGGCAGGGTTGCCCGAAA|AGTCCAATTATAAGCCACTCCACCCTATGC
TTAGAAAAGGGCACGTCGGCAGGGTTGCCC|GAATGTTTGCACGTTCTCGGATCAACGCGG
ATAGACTAGCACAAGCGTGATGTGGGTAAG|CTCCGCAACGCCATAACTCGGTCGGTTAGA
TTAACGGGTTTCGGGAGGGAGGCACGTCGG|CCACAGCTTCCTGATCCCCCATGTCGGAGT
CCAAGAGGCACGTCGGCAGGGTTGCCCGAA|CAAACAGCCATGCAGCGATACTTACAAGGT
CTGCTCGGCACGTCGGCAGGGTTGCCCGAA|CGATATACGGAACCCTGCGCGGCCGGCCGC
ACGCAACAACTCCGGCGAAGCTTATAACTC|GCGAATGGATGTTGCAAGTCAGCTAAAGCT
AAATGTGTGGCACGTCGGCAGGGTTGCCCG|GGCGAAAAGGCCAAGAGGCACGTCGGCAGG
TATCGTGGCTTGGTCACTGCTCGGCACGTC|TCCCTCCCGTCGGCCACGATATACGGAACC
TCAGCTTGTGAGGTGGTATAGACTAGCACA|AGAGTGGCCTTTTACAGCTCCGCAACGCCA
AGGGCCTGTAGCGACTATTCCCTCCCGTCG|GCAGGTGCGTAAAAGTCGGCACGTCGGCAG
AATGGATGTTGCAAGTCAGCTAAAGCTTGC|TAGCACAAGCGTGATGTGGGTAAGGCACGT
ACTGCTCGGCACGTCGGCAGGGTTGCCCGA|ACGATATACGGAACCCTGCGCGGCCGGCCG
CTCGGATCAACGCGGTGCGTCCGTTTCGTT|GGGTAGTAGGTGTGATAGTTTCCACCTAGC
GCTCCGCAACGCCATAACTCGGTCGGTTAG|TCATAGACACTTGAACCTTGCTGAGGGAAT
TTGCACGTTCTCGGATCAACGCGGTGCGTC|TATGAGAACGGGTAGTAGGTGTGATAGTTT
GCCATGCAGCGATACTTACAAGGTTCCGAA|GGCAGGGTTGCCCGAAAGGGCGCCCGAAAG
TGCTCGGCACGTCGGCAGGGTTGCCCGAAA|GATATACGGAACCCTGCGCGGCCGGCCGCC
AAGCTTATAACTCATTAGTAGTCCAATTAT|GTCAGCTAAAGCTTGCCGTATATACTTTGG
AAAGCTTGCCGTATATACTTTGGCGGGCCT|AAGGCACGTCGGCAGGGTTGCCCGAAAGGG
GTAGTCCAATTATAAGCCACTCCACCCTAT|GTATATACTTTGGCGGGCCTGTTGGCACGT
CGCAGATTGTGGCTAGGTCTCCACGAACCT|AACTCCTAGGCACGTCGGCAGGGTTGCCCG
AGGGTTGCCCGAAAGGGCGCCCGAAAGGGC|AATTAGACTCAGCTTGTGAGGTGGTATAGA
GCCACGATATACGGAACCCTGCGCGGCCGG|GGTTGCCCGAAAGGGCGTCGGTTTAATGCT
TGATCCCCCATGTCGGAGTATACCCCGGAC|GCAGGGTTGCCCGAAAGGGCGGGACAGGGA
CGGCAGGGTTGGGCACGTCGGCAGGGTTGC|AAGGGCGGACTACAAATCCCGTAATTAGAC
ACGTCGGCAGGGTTGCCCGAAAGGGCGAAA|TCGGAGTATACCCCGGACTTATGCGCAGAT
CGTCCGTTTCGTTTAACGGGTTTCGGGAGG|GTTTCCACCTAGCCACAGCTTCCTGATCCC
TGTTGCAAGTCAGCTAAAGCTTGCCGTATA|AAGCGTGATGTGGGTAAGGCACGTCGGCAG
TGGGCAGCCGTAAAATACAGCCCAAACAGC|ATGGCACGTCGGCAGGGTTGGGCACGTCGG
AGGGCGAAAAGGCCAAGAGGCACGTCGGCA|TAAAATACAGCCCAAACAGCCATGCAGCGA
CAGCTCCGCAACGCCATAACTCGGTCGGTT|TTTCATAGACACTTGAACCTTGCTGAGGGA
TTTCCACCTAGCCACAGCTTCCTGATCCCC|TTGGTCACTGCTCGGCACGTCGGCAGGGTT
GTTGCCCGAAAGGGCGAAATGTCACTGGGC|CCCGGACTTATGCGCAGATTGTGGCTAGGT
AGAACGGGTAGTAGGTGTGATAGTTTCCAC|TACCTGACTGAAAATATCGTGGCTTGGTCA
GTTTTGACTTTGAACGCGACCCGTATGGTG|AGTGGGCACGTCGGCAGGGTTGCCCGAAAG
TAGGTCTCCACGAACCTCGTCCTTAACCGA|GTCGGCAGGGTTGCCCGAAAGGGCGCATTG
GCGATTGATGGCACGTCGGCAGGGTTGGGC|CGGCAGGGTTGCCCGAAAGGGCGGACTACA
CGAAAAGGCCAAGAGGCACGTCGGCAGGGT|ATACAGCCCAAACAGCCATGCAGCGATACT
GAAAATATCGTGGCTTGGTCACTGCTCGGC|ACTATTCCCTCCCGTCGGCCACGATATACG
CACTCCACCCTATGCGATTGATGGCACGTC|CCTGTTGGCACGTCGGCAGGGTTGCCCGAA
AGCGACTATTCCCTCCCGTCGGCCACGATA|TAAAAGTCGGCACGTCGGCAGGGTTGCCCG
CGTCGGCAGGGTTGCCCGAAAGGGCGCATT|TGATCATCAGGAGCTTATTGTACAGTTTTT
AAAGGGCGAAAAGGCCAAGAGGCACGTCGG|CGTAAAATACAGCCCAAACAGCCATGCAGC
GTGAGGTGGTATAGACTAGCACAAGCGTGA|CCTTTTACAGCTCCGCAACGCCATAACTCG
CGCGACCCGTATGGTGGTACGATTGTTATC|CAGGGTTGCCCGAAAGGGCGCTAATCCGGT
TGAGAACGGGTAGTAGGTGTGATAGTTTCC|GTTACCTGACTGAAAATATCGTGGCTTGGT
AGGGCGCCCGAAAGGGCGAATGGATGTTGC|TTGTGAGGTGGTATAGACTAGCACAAGCGT
TTGGTCACTGCTCGGCACGTCGGCAGGGTT|TCGGCCACGATATACGGAACCCTGCGCGGC
AAAGGGCGCTAATCCGGTCGGACAATCTCT|GCACGTCGGCAGGGTTGCCCGAAAGGGCGA
CACGTCGGCAGGGTTGCCCGAAAGGGCGTG|TTATAAGCCACTCCACCCTATGCGATTGAT
TGATGGCACGTCGGCAGGGTTGGGCACGTC|GGGTTGCCCGAAAGGGCGGACTACAAATCC
GCTGAGGGAATGTTTGCACGTTCTCGGATC|TTTCCGGACTGCCTATGAGAACGGGTAGTA
GCGCTAATCCGGTCGGACAATCTCTGTAGT|TCGGCAGGGTTGCCCGAAAGGGCGAAATGT
CCTAGGCACGTCGGCAGGGTTGCCCGAAAG|AGCTCAGGTGATCATCAGGAGCTTATTGTA
CCCGAAAGGGCGGGACAGGGACTGCAAACT|GGCCGCCGATGGACGGAGAATGTGATGAAT
TCTCCACGAACCTCGTCCTTAACCGAAGGC|GCAGGGTTGCCCGAAAGGGCGCATTGAATA
GGGTTGCCCGAAAGGGCGGGGCGCTATCGA|CAACTCCGGCGAAGCTTATAACTCATTAGT
GTTTCCACCTAGCCACAGCTTCCTGATCCC|CTTGGTCACTGCTCGGCACGTCGGCAGGGT
ATGGCGGGTCAACAGACATGACCGGCACGT|GAGTTTGGGCACGTCGGCAGGGTTGCCCGA
AGCGTGATGTGGGTAAGGCACGTCGGCAGG|TAACTCGGTCGGTTAGAAAAGGGCACGTCG
GCTCGGCACGTCGGCAGGGTTGCCCGAAAG|ATATACGGAACCCTGCGCGGCCGGCCGCCG
GTCTTTTCATAGACACTTGAACCTTGCTGA|GTCACTGGGCGAATGACGAGAATCCTTTCC
GACACTTGAACCTTGCTGAGGGAATGTTTG|AATGACGAGAATCCTTTCCGGACTGCCTAT
CGTCGGCAGGGTTGCCCGAAAGGGCGGGGC|ACACGCAACAACTCCGGCGAAGCTTATAAC
GAGGGAGGCACGTCGGCAGGGTTGCCCGAA|TCCCCCATGTCGGAGTATACCCCGGACTTA
TTTACAGCTCCGCAACGCCATAACTCGGTC|GTCTTTTCATAGACACTTGAACCTTGCTGA
ACTATTCCCTCCCGTCGGCCACGATATACG|AGTCGGCACGTCGGCAGGGTTGCCCGAAAG
GAACCTCGTCCTTAACCGAAGGCTGTTACC|TGCCCGAAAGGGCGCATTGAATAGGGCCTG
CCTGTAGCGACTATTCCCTCCCGTCGGCCA|GTGCGTAAAAGTCGGCACGTCGGCAGGGTT
CCCTCCCGTCGGCCACGATATACGGAACCC|CACGTCGGCAGGGTTGCCCGAAAGGGCGTC
TTAGTAGTCCAATTATAAGCCACTCCACCC|GCCGTATATACTTTGGCGGGCCTGTTGGCA
CGGCAGGGTTGCCCGAAAGGGCGAGTGGGC|TCGGATCAACGCGGTGCGTCCGTTTCGTTT
GAATCCTTTCCGGACTGCCTATGAGAACGG|CCTCGTCCTTAACCGAAGGCTGTTACCTGA
CAGCGATACTTACAAGGTTCCGAACACGCA|GTTGCCCGAAAGGGCGCCCGAAAGGGCGAA
CGAAAGGGCGAGTGGGCACGTCGGCAGGGT|GTGCGTCCGTTTCGTTTAACGGGTTTCGGG
ACACTTGAACCTTGCTGAGGGAATGTTTGC|ATGACGAGAATCCTTTCCGGACTGCCTATG
AGACTAGCACAAGCGTGATGTGGGTAAGGC|CCGCAACGCCATAACTCGGTCGGTTAGAAA
GGCGCCCGAAAGGGCGAATGGATGTTGCAA|GTGAGGTGGTATAGACTAGCACAAGCGTGA
GCGGTGCGTCCGTTTCGTTTAACGGGTTTC|GTGATAGTTTCCACCTAGCCACAGCTTCCT
GTTCCGAACACGCAACAACTCCGGCGAAGC|CCCGAAAGGGCGAATGGATGTTGCAAGTCA
CGCCCGAAAGGGCGAATGGATGTTGCAAGT|GAGGTGGTATAGACTAGCACAAGCGTGATG
TGTGATAGTTTCCACCTAGCCACAGCTTCC|ATCGTGGCTTGGTCACTGCTCGGCACGTCG
TAGAAAAGGGCACGTCGGCAGGGTTGCCCG|AATGTTTGCACGTTCTCGGATCAACGCGGT
GACGAGAATCCTTTCCGGACTGCCTATGAG|ACGAACCTCGTCCTTAACCGAAGGCTGTTA
CGGTCGGACAATCTCTGTAGTCTTTTCATA|TTGCCCGAAAGGGCGAAATGTCACTGGGCG
GGCGGCATCGTTTTGACTTTGAACGCGACC|GAAAGGGCGAGTGGGCACGTCGGCAGGGTT
ATACTTTGGCGGGCCTGTTGGCACGTCGGC|GGGTTGCCCGAAAGGGCGGCATCGTTTTGA
TGGCACGTCGGCAGGGTTGGGCACGTCGGC|TTGCCCGAAAGGGCGGACTACAAATCCCGT
CTTTGAACGCGACCCGTATGGTGGTACGAT|ACGTCGGCAGGGTTGCCCGAAAGGGCGCTA
GCCCGAAAGGGCGAATGGATGTTGCAAGTC|AGGTGGTATAGACTAGCACAAGCGTGATGT
CCGAAAGGGCGAATGGATGTTGCAAGTCAG|GTGGTATAGACTAGCACAAGCGTGATGTGG
CACGTCGGCAGGGTTGCCCGAAAGGGCGCA|GGTGATCATCAGGAGCTTATTGTACAGTTT
ACACGCAACAACTCCGGCGAAGCTTATAAC|GGGCGAATGGATGTTGCAAGTCAGCTAAAG
GAAAGGGCGCCCGAAAGGGCGAATGGATGT|AGCTTGTGAGGTGGTATAGACTAGCACAAG
ATGAGAACGGGTAGTAGGTGTGATAGTTTC|TGTTACCTGACTGAAAATATCGTGGCTTGG
AATCTCTGTAGTCTTTTCATAGACACTTGA|AGGGCGAAATGTCACTGGGCGAATGACGAG
TGCGCAGATTGTGGCTAGGTCTCCACGAAC|CAAACTCCTAGGCACGTCGGCAGGGTTGCC
CCCGGACTTATGCGCAGATTGTGGCTAGGT|ACAGGGACTGCAAACTCCTAGGCACGTCGG
AATGTCACTGGGCGAATGACGAGAATCCTT|ATTGTGGCTAGGTCTCCACGAACCTCGTCC
AGCCATGCAGCGATACTTACAAGGTTCCGA|CGGCAGGGTTGCCCGAAAGGGCGCCCGAAA
CCACCTAGCCACAGCTTCCTGATCCCCCAT|GTCACTGCTCGGCACGTCGGCAGGGTTGCC
CGAAAGGGCGCTAATCCGGTCGGACAATCT|AGGCACGTCGGCAGGGTTGCCCGAAAGGGC
TGCTAGCCAAATTATCATGGCGGGTCAACA|AGGGCGGGGCGCTATCGAGTTTGGGCACGT
CCCGAAAGGGCGGACTACAAATCCCGTAAT|CGCGACCCGTATGGTGGTACGATTGTTATC
TTTTACAGCTCCGCAACGCCATAACTCGGT|AGTCTTTTCATAGACACTTGAACCTTGCTG
TCAACAGACATGACCGGCACGTCGGCAGGG|GCACGTCGGCAGGGTTGCCCGAAAGGGCGT
CCTAGCCACAGCTTCCTGATCCCCCATGTC|ACTGCTCGGCACGTCGGCAGGGTTGCCCGA
CGTCGGCAGGGTTGCCCGAAAGGGCGTGAC|AAGAGGCACGTCGGCAGGGTTGCCCGAAAG
AAAGGGCGTGGGCAGCCGTAAAATACAGCC|TGCGATTGATGGCACGTCGGCAGGGTTGGG
GGGTTGCCCGAAAGGGCGAGTGGGCACGTC|TCAACGCGGTGCGTCCGTTTCGTTTAACGG
AGTCCAATTATAAGCCACTCCACCCTATGC|ATATACTTTGGCGGGCCTGTTGGCACGTCG
AGGTGTGATAGTTTCCACCTAGCCACAGCT|AATATCGTGGCTTGGTCACTGCTCGGCACG
CATGTCGGAGTATACCCCGGACTTATGCGC|GCCCGAAAGGGCGGGACAGGGACTGCAAAC
GGCAGGGTTGCCCGAAAGGGCGGGACAGGG|CTGCGCGGCCGGCCGCCGATGGACGGAGAA
AATTAGACTCAGCTTGTGAGGTGGTATAGA|ATCGCACCAGAGTGGCCTTTTACAGCTCCG
ACAAGCGTGATGTGGGTAAGGCACGTCGGC|CCATAACTCGGTCGGTTAGAAAAGGGCACG
CTAAAGCTTGCCGTATATACTTTGGCGGGC|GTAAGGCACGTCGGCAGGGTTGCCCGAAAG
GCGAAATGTCACTGGGCGAATGACGAGAAT|GCAGATTGTGGCTAGGTCTCCACGAACCTC
GTTGCCCGAAAGGGCGGCATCGTTTTGACT|GCAGGGTTGCCCGAAAGGGCGAGTGGGCAC
GAAAGGGCGAGTGGGCACGTCGGCAGGGTT|TGCGTCCGTTTCGTTTAACGGGTTTCGGGA
GGTTGCCCGAAAGGGCGAGTGGGCACGTCG|CAACGCGGTGCGTCCGTTTCGTTTAACGGG
TCCCCCATGTCGGAGTATACCCCGGACTTA|GGGTTGCCCGAAAGGGCGGGACAGGGACTG
TCCGCAACGCCATAACTCGGTCGGTTAGAA|ATAGACACTTGAACCTTGCTGAGGGAATGT
TCGGAGTATACCCCGGACTTATGCGCAGAT|GAAAGGGCGGGACAGGGACTGCAAACTCCT
TTGAACGCGACCCGTATGGTGGTACGATTG|GTCGGCAGGGTTGCCCGAAAGGGCGCTAAT
GGTTGGGCACGTCGGCAGGGTTGCCCGAAA|GGACTACAAATCCCGTAATTAGACTCAGCT
CACGTCGGCAGGGTTGCCCGAAAGGGCGCC|AAATCCCGTAATTAGACTCAGCTTGTGAGG
GGCTTGGTCACTGCTCGGCACGTCGGCAGG|CCGTCGGCCACGATATACGGAACCCTGCGC
AACTCCTAGGCACGTCGGCAGGGTTGCCCG|GAATAGCTCAGGTGATCATCAGGAGCTTAT
AGGGTTGCCCGAAAGGGCGGCATCGTTTTG|TCGGCAGGGTTGCCCGAAAGGGCGAGTGGG
GGTCAGTTCACATGCTAGCCAAATTATCAT|GGGTTGCCCGAAAGGGCGGGGCGCTATCGA
AGGCACGTCGGCAGGGTTGCCCGAAAGGGC|GAAAAGGGCACGTCGGCAGGGTTGCCCGAA
GCACGTCGGCAGGGTTGCCCGAAAGGGCGA|GCCCGAAAGGGCGTGGGCAGCCGTAAAATA
ATGGATGTTGCAAGTCAGCTAAAGCTTGCC|AGCACAAGCGTGATGTGGGTAAGGCACGTC
ACGTCGGCAGGGTTGCCCGAAAGGGCGCAT|GTGATCATCAGGAGCTTATTGTACAGTTTT
GACTCTCTTATTCGGGTCAGTTCACATGCT|AAGGCACGTCGGCAGGGTTGCCCGAAAGGG
AGTCTTTTCATAGACACTTGAACCTTGCTG|TGTCACTGGGCGAATGACGAGAATCCTTTC
ACCTGACTGAAAATATCGTGGCTTGGTCAC|CTGTAGCGACTATTCCCTCCCGTCGGCCAC
GTCGGTTAGAAAAGGGCACGTCGGCAGGGT|TGAGGGAATGTTTGCACGTTCTCGGATCAA
GCCTGTAGCGACTATTCCCTCCCGTCGGCC|GGTGCGTAAAAGTCGGCACGTCGGCAGGGT
CGGGCCTGTTGGCACGTCGGCAGGGTTGCC|GAAAGGGCGGCATCGTTTTGACTTTGAACG
GGACTTATGCGCAGATTGTGGCTAGGTCTC|GGGACTGCAAACTCCTAGGCACGTCGGCAG
GAAAGGGCGGACTACAAATCCCGTAATTAG|GACCCGTATGGTGGTACGATTGTTATCGCA
ATTGAATAGGGCCTGTAGCGACTATTCCCT|TTTCGTAGCAGGTGCGTAAAAGTCGGCACG
GGCCACGATATACGGAACCCTGCGCGGCCG|GGGTTGCCCGAAAGGGCGTCGGTTTAATGC
TTGCCCGAAAGGGCGAAATGTCACTGGGCG|CCGGACTTATGCGCAGATTGTGGCTAGGTC
GAGGCACGTCGGCAGGGTTGCCCGAAAGGC|CAGCCATGCAGCGATACTTACAAGGTTCCG
GATGTTGCAAGTCAGCTAAAGCTTGCCGTA|ACAAGCGTGATGTGGGTAAGGCACGTCGGC
CTAATCCGGTCGGACAATCTCTGTAGTCTT|GCAGGGTTGCCCGAAAGGGCGAAATGTCAC
ACTCATTAGTAGTCCAATTATAAGCCACTC|AGCTTGCCGTATATACTTTGGCGGGCCTGT
GTCGGCAGGGTTGCCCGAAAGGGCGGACTA|TTTTGACTTTGAACGCGACCCGTATGGTGG
GGCCTGTTGGCACGTCGGCAGGGTTGCCCG|AAGGGCGGCATCGTTTTGACTTTGAACGCG
TTGCCCGAAAGGGCGGCATCGTTTTGACTT|CAGGGTTGCCCGAAAGGGCGAGTGGGCACG
GCACGTCGGCAGGGTTGCCCGAAAGGGCGT|ATTATAAGCCACTCCACCCTATGCGATTGA
TGTGTGGCACGTCGGCAGGGTTGCCCGAAA|GAAAAGGCCAAGAGGCACGTCGGCAGGGTT
AGGGTTGCCCGAAAGGGCGAGTGGGCACGT|ATCAACGCGGTGCGTCCGTTTCGTTTAACG
TCGGCCACGATATACGGAACCCTGCGCGGC|CAGGGTTGCCCGAAAGGGCGTCGGTTTAAT
AGGGAGGCACGTCGGCAGGGTTGCCCGAAA|CCCCCATGTCGGAGTATACCCCGGACTTAT
ACTCTCTTATTCGGGTCAGTTCACATGCTA|AGGCACGTCGGCAGGGTTGCCCGAAAGGGC
GCCGTAAAATACAGCCCAAACAGCCATGCA|CGTCGGCAGGGTTGGGCACGTCGGCAGGGT
GGTGCGTCCGTTTCGTTTAACGGGTTTCGG|GATAGTTTCCACCTAGCCACAGCTTCCTGA
GCAGGGTTGCCCGAAAGGGCGCATTGAATA|ATCAGGAGCTTATTGTACAGTTTTTCGTAG
GCACGTCGGCAGGGTTGGGCACGTCGGCAG|GCCCGAAAGGGCGGACTACAAATCCCGTAA
TAATCCGGTCGGACAATCTCTGTAGTCTTT|CAGGGTTGCCCGAAAGGGCGAAATGTCACT
GACTTATGCGCAGATTGTGGCTAGGTCTCC|GGACTGCAAACTCCTAGGCACGTCGGCAGG
GGTGGTATAGACTAGCACAAGCGTGATGTG|TTACAGCTCCGCAACGCCATAACTCGGTCG
CCGTCGGCCACGATATACGGAACCCTGCGC|CGGCAGGGTTGCCCGAAAGGGCGTCGGTTT
GAAAGGGCGAAAAGGCCAAGAGGCACGTCG|CCGTAAAATACAGCCCAAACAGCCATGCAG
CCGAAAGGGCGCATTGAATAGGGCCTGTAG|TATTGTACAGTTTTTCGTAGCAGGTGCGTA
TCCGAACACGCAACAACTCCGGCGAAGCTT|CGAAAGGGCGAATGGATGTTGCAAGTCAGC
GAAGGCTGTTACCTGACTGAAAATATCGTG|TGAATAGGGCCTGTAGCGACTATTCCCTCC
GTTGCCCGAAAGGGCGAGTGGGCACGTCGG|AACGCGGTGCGTCCGTTTCGTTTAACGGGT
TCCTTTCCGGACTGCCTATGAGAACGGGTA|CGTCCTTAACCGAAGGCTGTTACCTGACTG
TTGGCGGGCCTGTTGGCACGTCGGCAGGGT|GCCCGAAAGGGCGGCATCGTTTTGACTTTG
GTTGCCCGAAAGGGCGCATTGAATAGGGCC|GAGCTTATTGTACAGTTTTTCGTAGCAGGT
GGCGGGACAGGGACTGCAAACTCCTAGGCA|ATGGACGGAGAATGTGATGAATAGCTCAGG
TCTTTTCATAGACACTTGAACCTTGCTGAG|TCACTGGGCGAATGACGAGAATCCTTTCCG
GCAAGTCAGCTAAAGCTTGCCGTATATACT|GTGATGTGGGTAAGGCACGTCGGCAGGGTT
TTGGCACGTCGGCAGGGTTGCCCGAAAGGG|GGCATCGTTTTGACTTTGAACGCGACCCGT
AAAGGGCGGGACAGGGACTGCAAACTCCTA|GCCGATGGACGGAGAATGTGATGAATAGCT
GGTTCCGAACACGCAACAACTCCGGCGAAG|GCCCGAAAGGGCGAATGGATGTTGCAAGTC
CCTCCCGTCGGCCACGATATACGGAACCCT|ACGTCGGCAGGGTTGCCCGAAAGGGCGTCG
CTTTTACAGCTCCGCAACGCCATAACTCGG|TAGTCTTTTCATAGACACTTGAACCTTGCT
TCCTTAACCGAAGGCTGTTACCTGACTGAA|AGGGCGCATTGAATAGGGCCTGTAGCGACT
AAAGGGCGGGGCGCTATCGAGTTTGGGCAC|GAAGCTTATAACTCATTAGTAGTCCAATTA
GTCGGCAGGGTTGCCCGAAAGGGCGTGACT|AGAGGCACGTCGGCAGGGTTGCCCGAAAGG
CTTGCCGTATATACTTTGGCGGGCCTGTTG|CACGTCGGCAGGGTTGCCCGAAAGGGCGGC
ATAACTCATTAGTAGTCCAATTATAAGCCA|TAAAGCTTGCCGTATATACTTTGGCGGGCC
TGATGTGGGTAAGGCACGTCGGCAGGGTTG|TCGGTCGGTTAGAAAAGGGCACGTCGGCAG
GGTATAGACTAGCACAAGCGTGATGTGGGT|CAGCTCCGCAACGCCATAACTCGGTCGGTT
GGACAATCTCTGTAGTCTTTTCATAGACAC|CGAAAGGGCGAAATGTCACTGGGCGAATGA
TCCAATTATAAGCCACTCCACCCTATGCGA|ATACTTTGGCGGGCCTGTTGGCACGTCGGC
GTATATACTTTGGCGGGCCTGTTGGCACGT|GGCAGGGTTGCCCGAAAGGGCGGCATCGTT
GGCCTGTAGCGACTATTCCCTCCCGTCGGC|AGGTGCGTAAAAGTCGGCACGTCGGCAGGG
CCATAACTCGGTCGGTTAGAAAAGGGCACG|TGAACCTTGCTGAGGGAATGTTTGCACGTT
AAGGGCGGGACAGGGACTGCAAACTCCTAG|CCGATGGACGGAGAATGTGATGAATAGCTC
CCGTAAAATACAGCCCAAACAGCCATGCAG|GTCGGCAGGGTTGGGCACGTCGGCAGGGTT
GAGTTAAAATGTGTGGCACGTCGGCAGGGT|CGAAAGGGCGAAAAGGCCAAGAGGCACGTC
CCCCGGACTTATGCGCAGATTGTGGCTAGG|GACAGGGACTGCAAACTCCTAGGCACGTCG
GCTTGCCGTATATACTTTGGCGGGCCTGTT|GCACGTCGGCAGGGTTGCCCGAAAGGGCGG
GGATCAACGCGGTGCGTCCGTTTCGTTTAA|TAGTAGGTGTGATAGTTTCCACCTAGCCAC
TAGGTGTGATAGTTTCCACCTAGCCACAGC|AAATATCGTGGCTTGGTCACTGCTCGGCAC
TCCGGTCGGACAATCTCTGTAGTCTTTTCA|GGTTGCCCGAAAGGGCGAAATGTCACTGGG
AAGGGCGAAAAGGCCAAGAGGCACGTCGGC|GTAAAATACAGCCCAAACAGCCATGCAGCG
TTATAACTCATTAGTAGTCCAATTATAAGC|GCTAAAGCTTGCCGTATATACTTTGGCGGG
GTCCTTAACCGAAGGCTGTTACCTGACTGA|AAGGGCGCATTGAATAGGGCCTGTAGCGAC
GGCAGGGTTGCCCGAAAGGCACGTCGGCAG|GCGATACTTACAAGGTTCCGAACACGCAAC
CATAACTCGGTCGGTTAGAAAAGGGCACGT|GAACCTTGCTGAGGGAATGTTTGCACGTTC
TGTCACTGGGCGAATGACGAGAATCCTTTC|TGTGGCTAGGTCTCCACGAACCTCGTCCTT
CGGGAGGGAGGCACGTCGGCAGGGTTGCCC|TGATCCCCCATGTCGGAGTATACCCCGGAC
GGGTTGCCCGAAAGGGCGAAATGTCACTGG|ACCCCGGACTTATGCGCAGATTGTGGCTAG
GATGTGGGTAAGGCACGTCGGCAGGGTTGC|CGGTCGGTTAGAAAAGGGCACGTCGGCAGG
GAAAGGGCGCTAATCCGGTCGGACAATCTC|GGCACGTCGGCAGGGTTGCCCGAAAGGGCG
CGGCAGGGTTGCCCGAAAGGGCGGCATCGT|CACGTCGGCAGGGTTGCCCGAAAGGGCGAG
AAAGGGCGAAATGTCACTGGGCGAATGACG|TATGCGCAGATTGTGGCTAGGTCTCCACGA
GAAAGGGCGAATGGATGTTGCAAGTCAGCT|GGTATAGACTAGCACAAGCGTGATGTGGGT
CAGGGTTGCCCGAAAGGGCGGGACAGGGAC|GCGCGGCCGGCCGCCGATGGACGGAGAATG
CGAATGACGAGAATCCTTTCCGGACTGCCT|TCTCCACGAACCTCGTCCTTAACCGAAGGC
CTCCACGAACCTCGTCCTTAACCGAAGGCT|CAGGGTTGCCCGAAAGGGCGCATTGAATAG
ACTGAGTTAAAATGTGTGGCACGTCGGCAG|GCCCGAAAGGGCGAAAAGGCCAAGAGGCAC
CTATGCGATTGATGGCACGTCGGCAGGGTT|ACGTCGGCAGGGTTGCCCGAAAGGGCGGAC
TTACCTGACTGAAAATATCGTGGCTTGGTC|GCCTGTAGCGACTATTCCCTCCCGTCGGCC
CGTCGGCAGGGTTGCCCGAAAGGGCGGCAT|GGGCACGTCGGCAGGGTTGCCCGAAAGGGC
TGCCCGAAAGGGCGAGTGGGCACGTCGGCA|CGCGGTGCGTCCGTTTCGTTTAACGGGTTT
TAGACACTTGAACCTTGCTGAGGGAATGTT|CGAATGACGAGAATCCTTTCCGGACTGCCT
CCTGTTGGCACGTCGGCAGGGTTGCCCGAA|GGGCGGCATCGTTTTGACTTTGAACGCGAC
GATTGTGGCTAGGTCTCCACGAACCTCGTC|CCTAGGCACGTCGGCAGGGTTGCCCGAAAG
GGCTGTTACCTGACTGAAAATATCGTGGCT|ATAGGGCCTGTAGCGACTATTCCCTCCCGT
GGGTAAGGCACGTCGGCAGGGTTGCCCGAA|GGTTAGAAAAGGGCACGTCGGCAGGGTTGC
CCTCGTCCTTAACCGAAGGCTGTTACCTGA|CCGAAAGGGCGCATTGAATAGGGCCTGTAG
AAGTCAGCTAAAGCTTGCCGTATATACTTT|GATGTGGGTAAGGCACGTCGGCAGGGTTGC
GTCGGCAGGGTTGCCCGAAAGGGCGCCCGA|TCCCGTAATTAGACTCAGCTTGTGAGGTGG
CTTCCTGATCCCCCATGTCGGAGTATACCC|CGTCGGCAGGGTTGCCCGAAAGGGCGGGAC
CCTTGCTGAGGGAATGTTTGCACGTTCTCG|ATCCTTTCCGGACTGCCTATGAGAACGGGT
GCCTATGAGAACGGGTAGTAGGTGTGATAG|AGGCTGTTACCTGACTGAAAATATCGTGGC
CTGACTGAAAATATCGTGGCTTGGTCACTG|GTAGCGACTATTCCCTCCCGTCGGCCACGA
GTGCGTCCGTTTCGTTTAACGGGTTTCGGG|ATAGTTTCCACCTAGCCACAGCTTCCTGAT
GAACGGGTAGTAGGTGTGATAGTTTCCACC|ACCTGACTGAAAATATCGTGGCTTGGTCAC
ACCTTGCTGAGGGAATGTTTGCACGTTCTC|AATCCTTTCCGGACTGCCTATGAGAACGGG
AGCCGTAAAATACAGCCCAAACAGCCATGC|ACGTCGGCAGGGTTGGGCACGTCGGCAGGG
AAGGGCGAGTGGGCACGTCGGCAGGGTTGC|CGTCCGTTTCGTTTAACGGGTTTCGGGAGG
CTGTAGTCTTTTCATAGACACTTGAACCTT|GAAATGTCACTGGGCGAATGACGAGAATCC
GCTAGGTCTCCACGAACCTCGTCCTTAACC|ACGTCGGCAGGGTTGCCCGAAAGGGCGCAT
GGGCGAATGGATGTTGCAAGTCAGCTAAAG|TAGACTAGCACAAGCGTGATGTGGGTAAGG
GTAGTCTTTTCATAGACACTTGAACCTTGC|AATGTCACTGGGCGAATGACGAGAATCCTT
CAGCTTGTGAGGTGGTATAGACTAGCACAA|GAGTGGCCTTTTACAGCTCCGCAACGCCAT
CATGCTAGCCAAATTATCATGGCGGGTCAA|AAAGGGCGGGGCGCTATCGAGTTTGGGCAC
AGGGTTGGGCACGTCGGCAGGGTTGCCCGA|GCGGACTACAAATCCCGTAATTAGACTCAG
TGTAGTCTTTTCATAGACACTTGAACCTTG|AAATGTCACTGGGCGAATGACGAGAATCCT
ACAGCTTCCTGATCCCCCATGTCGGAGTAT|GGCACGTCGGCAGGGTTGCCCGAAAGGGCG
CGAAGCTTATAACTCATTAGTAGTCCAATT|AAGTCAGCTAAAGCTTGCCGTATATACTTT
TGGGCACGTCGGCAGGGTTGCCCGAAAGGG|CTACAAATCCCGTAATTAGACTCAGCTTGT
GGGTCAACAGACATGACCGGCACGTCGGCA|TGGGCACGTCGGCAGGGTTGCCCGAAAGGG
AAGGCACGTCGGCAGGGTTGCCCGAAAGGG|TTCCGAACACGCAACAACTCCGGCGAAGCT
GGGCGCCCGAAAGGGCGAATGGATGTTGCA|TGTGAGGTGGTATAGACTAGCACAAGCGTG
GCCACTCCACCCTATGCGATTGATGGCACG|GGCCTGTTGGCACGTCGGCAGGGTTGCCCG
ACGTCGGCAGGGTTGCCCGAAAGGGCGTGG|TATAAGCCACTCCACCCTATGCGATTGATG
GGCACGTCGGCAGGGTTGCCCGAAAGGGCG|TGCCCGAAAGGGCGTGGGCAGCCGTAAAAT
ATCGAGTTTGGGCACGTCGGCAGGGTTGCC|TTAGTAGTCCAATTATAAGCCACTCCACCC
ATAACTCGGTCGGTTAGAAAAGGGCACGTC|AACCTTGCTGAGGGAATGTTTGCACGTTCT
TGGGCGAATGACGAGAATCCTTTCCGGACT|TAGGTCTCCACGAACCTCGTCCTTAACCGA
GGATGTTGCAAGTCAGCTAAAGCTTGCCGT|CACAAGCGTGATGTGGGTAAGGCACGTCGG
CTGATCCCCCATGTCGGAGTATACCCCGGA|GGCAGGGTTGCCCGAAAGGGCGGGACAGGG
TGGGTAAGGCACGTCGGCAGGGTTGCCCGA|CGGTTAGAAAAGGGCACGTCGGCAGGGTTG
TGGTACGATTGTTATCGCACCAGAGTGGCC|AGGGCGCTAATCCGGTCGGACAATCTCTGT
TTTCATAGACACTTGAACCTTGCTGAGGGA|CTGGGCGAATGACGAGAATCCTTTCCGGAC
TTCCACCTAGCCACAGCTTCCTGATCCCCC|TGGTCACTGCTCGGCACGTCGGCAGGGTTG
AGGCACGTCGGCAGGGTTGCCCGAAAGGGC|TCAGGTGATCATCAGGAGCTTATTGTACAG
GATCAACGCGGTGCGTCCGTTTCGTTTAAC|AGTAGGTGTGATAGTTTCCACCTAGCCACA
CAACAACTCCGGCGAAGCTTATAACTCATT|AATGGATGTTGCAAGTCAGCTAAAGCTTGC
GTTTAACGGGTTTCGGGAGGGAGGCACGTC|AGCCACAGCTTCCTGATCCCCCATGTCGGA
CGGAGTATACCCCGGACTTATGCGCAGATT|AAAGGGCGGGACAGGGACTGCAAACTCCTA
ACGTCGGCAGGGTTGGGCACGTCGGCAGGG|CCGAAAGGGCGGACTACAAATCCCGTAATT
CTCTCTTATTCGGGTCAGTTCACATGCTAG|GGCACGTCGGCAGGGTTGCCCGAAAGGGCG
AAGGGCGCCCGAAAGGGCGAATGGATGTTG|CTTGTGAGGTGGTATAGACTAGCACAAGCG
GTTTCGGGAGGGAGGCACGTCGGCAGGGTT|TTCCTGATCCCCCATGTCGGAGTATACCCC
GGCGTGGGCAGCCGTAAAATACAGCCCAAA|ATTGATGGCACGTCGGCAGGGTTGGGCACG
AGTGGCCTTTTACAGCTCCGCAACGCCATA|TCTCTGTAGTCTTTTCATAGACACTTGAAC
GTCGGCCACGATATACGGAACCCTGCGCGG|GCAGGGTTGCCCGAAAGGGCGTCGGTTTAA
AGGGACTGCAAACTCCTAGGCACGTCGGCA|AGAATGTGATGAATAGCTCAGGTGATCATC
AAAGGGCGCCCGAAAGGGCGAATGGATGTT|GCTTGTGAGGTGGTATAGACTAGCACAAGC
GCAGATTGTGGCTAGGTCTCCACGAACCTC|ACTCCTAGGCACGTCGGCAGGGTTGCCCGA
CCCAAACAGCCATGCAGCGATACTTACAAG|GGCACGTCGGCAGGGTTGCCCGAAAGGGCG
ATTGATGGCACGTCGGCAGGGTTGGGCACG|CAGGGTTGCCCGAAAGGGCGGACTACAAAT
CACCAGAGTGGCCTTTTACAGCTCCGCAAC|GGACAATCTCTGTAGTCTTTTCATAGACAC
TCACATGCTAGCCAAATTATCATGGCGGGT|CCGAAAGGGCGGGGCGCTATCGAGTTTGGG
GGTTTCGGGAGGGAGGCACGTCGGCAGGGT|CTTCCTGATCCCCCATGTCGGAGTATACCC
GGGAGGCACGTCGGCAGGGTTGCCCGAAAG|CCCCATGTCGGAGTATACCCCGGACTTATG
TTATAAGCCACTCCACCCTATGCGATTGAT|TTGGCGGGCCTGTTGGCACGTCGGCAGGGT
CAGACATGACCGGCACGTCGGCAGGGTTGC|GTCGGCAGGGTTGCCCGAAAGGGCGTGGGC
CAAGGTTCCGAACACGCAACAACTCCGGCG|GGCGCCCGAAAGGGCGAATGGATGTTGCAA
AGGGCGCATTGAATAGGGCCTGTAGCGACT|TACAGTTTTTCGTAGCAGGTGCGTAAAAGT
GACTGAAAATATCGTGGCTTGGTCACTGCT|AGCGACTATTCCCTCCCGTCGGCCACGATA
CATGACCGGCACGTCGGCAGGGTTGCCCGA|GCAGGGTTGCCCGAAAGGGCGTGGGCAGCC
CCCGAAAGGGCGGGGCGCTATCGAGTTTGG|CGGCGAAGCTTATAACTCATTAGTAGTCCA
TGTCGGAGTATACCCCGGACTTATGCGCAG|CCGAAAGGGCGGGACAGGGACTGCAAACTC
TCAGCTAAAGCTTGCCGTATATACTTTGGC|GTGGGTAAGGCACGTCGGCAGGGTTGCCCG
CTAGGCACGTCGGCAGGGTTGCCCGAAAGG|GCTCAGGTGATCATCAGGAGCTTATTGTAC
GGCACGTCGGCAGGGTTGCCCGAAAGGGCG|CACGTTCTCGGATCAACGCGGTGCGTCCGT
GTTGCCCGAAAGGGCGAAAAGGCCAAGAGG|TGGGCAGCCGTAAAATACAGCCCAAACAGC
GTGGGTAAGGCACGTCGGCAGGGTTGCCCG|TCGGTTAGAAAAGGGCACGTCGGCAGGGTT
TTGCCCGAAAGGGCGCTAATCCGGTCGGAC|GAGGGAGGCACGTCGGCAGGGTTGCCCGAA
TATCATGGCGGGTCAACAGACATGACCGGC|TATCGAGTTTGGGCACGTCGGCAGGGTTGC
CGTCGGCAGGGTTGCCCGAAAGGGCGAGTG|TTCTCGGATCAACGCGGTGCGTCCGTTTCG
ACGCCATAACTCGGTCGGTTAGAAAAGGGC|ACTTGAACCTTGCTGAGGGAATGTTTGCAC
AAAAGGCCAAGAGGCACGTCGGCAGGGTTG|ACAGCCCAAACAGCCATGCAGCGATACTTA
CGTGGGCAGCCGTAAAATACAGCCCAAACA|TGATGGCACGTCGGCAGGGTTGGGCACGTC
CCGAAAGGGCGGCATCGTTTTGACTTTGAA|GTTGCCCGAAAGGGCGAGTGGGCACGTCGG
GGAGGGAGGCACGTCGGCAGGGTTGCCCGA|ATCCCCCATGTCGGAGTATACCCCGGACTT
GTGGCTAGGTCTCCACGAACCTCGTCCTTA|GGCACGTCGGCAGGGTTGCCCGAAAGGGCG
GGCACGTCGGCAGGGTTGCCCGAAAGGGCG|GGCCAAGAGGCACGTCGGCAGGGTTGCCCG
AGGGTTGCCCGAAAGGGCGGGACAGGGACT|CGCGGCCGGCCGCCGATGGACGGAGAATGT
ATTATCATGGCGGGTCAACAGACATGACCG|GCTATCGAGTTTGGGCACGTCGGCAGGGTT
TACAAATCCCGTAATTAGACTCAGCTTGTG|GGTACGATTGTTATCGCACCAGAGTGGCCT
TAGTAGGTGTGATAGTTTCCACCTAGCCAC|TGAAAATATCGTGGCTTGGTCACTGCTCGG
ATTGTTATCGCACCAGAGTGGCCTTTTACA|TAATCCGGTCGGACAATCTCTGTAGTCTTT
GTCAACAGACATGACCGGCACGTCGGCAGG|GGCACGTCGGCAGGGTTGCCCGAAAGGGCG
GGCGTGACTCTCTTATTCGGGTCAGTTCAC|CCCGAAAGGCACGTCGGCAGGGTTGCCCGA
GGTGTGATAGTTTCCACCTAGCCACAGCTT|ATATCGTGGCTTGGTCACTGCTCGGCACGT
TGCCCGAAAGGGCGGCATCGTTTTGACTTT|AGGGTTGCCCGAAAGGGCGAGTGGGCACGT
TTGACTTTGAACGCGACCCGTATGGTGGTA|GGGCACGTCGGCAGGGTTGCCCGAAAGGGC
TTATCATGGCGGGTCAACAGACATGACCGG|CTATCGAGTTTGGGCACGTCGGCAGGGTTG
CGAAAGGGCGGACTACAAATCCCGTAATTA|CGACCCGTATGGTGGTACGATTGTTATCGC
CCACAGCTTCCTGATCCCCCATGTCGGAGT|TCGGCACGTCGGCAGGGTTGCCCGAAAGGG
GGGTTTCGGGAGGGAGGCACGTCGGCAGGG|GCTTCCTGATCCCCCATGTCGGAGTATACC
ACAAGGTTCCGAACACGCAACAACTCCGGC|GGGCGCCCGAAAGGGCGAATGGATGTTGCA
CCGAAGGCTGTTACCTGACTGAAAATATCG|ATTGAATAGGGCCTGTAGCGACTATTCCCT
CGGGTTTCGGGAGGGAGGCACGTCGGCAGG|AGCTTCCTGATCCCCCATGTCGGAGTATAC
GATAGTTTCCACCTAGCCACAGCTTCCTGA|GTGGCTTGGTCACTGCTCGGCACGTCGGCA
GGGCACGTCGGCAGGGTTGCCCGAAAGGGC|GTTTAACGGGTTTCGGGAGGGAGGCACGTC
GCGGGGCGCTATCGAGTTTGGGCACGTCGG|TTATAACTCATTAGTAGTCCAATTATAAGC
TAATTAGACTCAGCTTGTGAGGTGGTATAG|TATCGCACCAGAGTGGCCTTTTACAGCTCC
TCGGCAGGGTTGCCCGAAAGGGCGGGACAG|CCCTGCGCGGCCGGCCGCCGATGGACGGAG
CAGCCATGCAGCGATACTTACAAGGTTCCG|TCGGCAGGGTTGCCCGAAAGGGCGCCCGAA
CTTATAACTCATTAGTAGTCCAATTATAAG|AGCTAAAGCTTGCCGTATATACTTTGGCGG
AAACTCCTAGGCACGTCGGCAGGGTTGCCC|TGAATAGCTCAGGTGATCATCAGGAGCTTA
CTTATTCGGGTCAGTTCACATGCTAGCCAA|CGTCGGCAGGGTTGCCCGAAAGGGCGGGGC
ATAAGCCACTCCACCCTATGCGATTGATGG|GGCGGGCCTGTTGGCACGTCGGCAGGGTTG
TAGGGCCTGTAGCGACTATTCCCTCCCGTC|AGCAGGTGCGTAAAAGTCGGCACGTCGGCA
TCGGCAGGGTTGCCCGAAAGGGCGCATTGA|ATCATCAGGAGCTTATTGTACAGTTTTTCG
CAGGGTTGCCCGAAAGGGCGTGGGCAGCCG|CACTCCACCCTATGCGATTGATGGCACGTC
CAATCTCTGTAGTCTTTTCATAGACACTTG|AAGGGCGAAATGTCACTGGGCGAATGACGA
TTGAACCTTGCTGAGGGAATGTTTGCACGT|CGAGAATCCTTTCCGGACTGCCTATGAGAA
GCCCGAAAGGGCGGGGCGCTATCGAGTTTG|CCGGCGAAGCTTATAACTCATTAGTAGTCC
TGACCGGCACGTCGGCAGGGTTGCCCGAAA|AGGGTTGCCCGAAAGGGCGTGGGCAGCCGT
GTCGGCAGGGTTGCCCGAAAGGGCGTGGGC|TAAGCCACTCCACCCTATGCGATTGATGGC
CACAGCTTCCTGATCCCCCATGTCGGAGTA|CGGCACGTCGGCAGGGTTGCCCGAAAGGGC
CGGGTCAACAGACATGACCGGCACGTCGGC|TTGGGCACGTCGGCAGGGTTGCCCGAAAGG
AGGTCTCCACGAACCTCGTCCTTAACCGAA|TCGGCAGGGTTGCCCGAAAGGGCGCATTGA
AATCCCGTAATTAGACTCAGCTTGTGAGGT|CGATTGTTATCGCACCAGAGTGGCCTTTTA
GCCCGAAAGGCACGTCGGCAGGGTTGCCCG|ACAAGGTTCCGAACACGCAACAACTCCGGC
GGCGGGGCGCTATCGAGTTTGGGCACGTCG|CTTATAACTCATTAGTAGTCCAATTATAAG
GGGCGAAATGTCACTGGGCGAATGACGAGA|GCGCAGATTGTGGCTAGGTCTCCACGAACC
GTTGCCCGAAAGGGCGTGACTCTCTTATTC|TCGGCAGGGTTGCCCGAAAGGCACGTCGGC
TTATTCGGGTCAGTTCACATGCTAGCCAAA|GTCGGCAGGGTTGCCCGAAAGGGCGGGGCG
AGGGTTGCCCGAAAGGGCGTGACTCTCTTA|ACGTCGGCAGGGTTGCCCGAAAGGCACGTC
TATGCGCAGATTGTGGCTAGGTCTCCACGA|TGCAAACTCCTAGGCACGTCGGCAGGGTTG
TATATACTTTGGCGGGCCTGTTGGCACGTC|GCAGGGTTGCCCGAAAGGGCGGCATCGTTT
ACGAGAATCCTTTCCGGACTGCCTATGAGA|CGAACCTCGTCCTTAACCGAAGGCTGTTAC
CTAGCCACAGCTTCCTGATCCCCCATGTCG|CTGCTCGGCACGTCGGCAGGGTTGCCCGAA
GGGCGGGACAGGGACTGCAAACTCCTAGGC|GATGGACGGAGAATGTGATGAATAGCTCAG
GCCCGAAAGGGCGCTAATCCGGTCGGACAA|GGGAGGCACGTCGGCAGGGTTGCCCGAAAG
TGTTTGCACGTTCTCGGATCAACGCGGTGC|GCCTATGAGAACGGGTAGTAGGTGTGATAG
TAACGGGTTTCGGGAGGGAGGCACGTCGGC|CACAGCTTCCTGATCCCCCATGTCGGAGTA
TGTTGGCACGTCGGCAGGGTTGCCCGAAAG|GCGGCATCGTTTTGACTTTGAACGCGACCC
GCACGTCGGCAGGGTTGCCCGAAAGGGCGG|CGGAACCCTGCGCGGCCGGCCGCCGATGGA
AAATTATCATGGCGGGTCAACAGACATGAC|GCGCTATCGAGTTTGGGCACGTCGGCAGGG
CTATGAGAACGGGTAGTAGGTGTGATAGTT|GCTGTTACCTGACTGAAAATATCGTGGCTT
ACGTCGGCAGGGTTGCCCGAAAGGGCGGGA|GAACCCTGCGCGGCCGGCCGCCGATGGACG
TTGCCCGAAAGGCACGTCGGCAGGGTTGCC|TTACAAGGTTCCGAACACGCAACAACTCCG
TCGGCAGGGTTGCCCGAAAGGGCGTGGGCA|AAGCCACTCCACCCTATGCGATTGATGGCA
GGCACGTCGGCAGGGTTGCCCGAAAGGCAC|GCCATGCAGCGATACTTACAAGGTTCCGAA
AATCCGGTCGGACAATCTCTGTAGTCTTTT|AGGGTTGCCCGAAAGGGCGAAATGTCACTG
GTCGGCAGGGTTGCCCGAAAGGGCGGCATC|GGCACGTCGGCAGGGTTGCCCGAAAGGGCG
GCGTGACTCTCTTATTCGGGTCAGTTCACA|CCGAAAGGCACGTCGGCAGGGTTGCCCGAA
CGTATATACTTTGGCGGGCCTGTTGGCACG|CGGCAGGGTTGCCCGAAAGGGCGGCATCGT
TCGGCAGGGTTGCCCGAAAGGGCGGGGCGC|ACGCAACAACTCCGGCGAAGCTTATAACTC
CTATCGAGTTTGGGCACGTCGGCAGGGTTG|CATTAGTAGTCCAATTATAAGCCACTCCAC
GAGGGAATGTTTGCACGTTCTCGGATCAAC|CCGGACTGCCTATGAGAACGGGTAGTAGGT
GGCAGGGTTGCCCGAAAGGGCGTGGGCAGC|GCCACTCCACCCTATGCGATTGATGGCACG
CTGGGCGAATGACGAGAATCCTTTCCGGAC|CTAGGTCTCCACGAACCTCGTCCTTAACCG
AACGCCATAACTCGGTCGGTTAGAAAAGGG|CACTTGAACCTTGCTGAGGGAATGTTTGCA
CATCGTTTTGACTTTGAACGCGACCCGTAT|GGCGAGTGGGCACGTCGGCAGGGTTGCCCG
GTTGGCACGTCGGCAGGGTTGCCCGAAAGG|CGGCATCGTTTTGACTTTGAACGCGACCCG
ATATACTTTGGCGGGCCTGTTGGCACGTCG|CAGGGTTGCCCGAAAGGGCGGCATCGTTTT
CCTATGCGATTGATGGCACGTCGGCAGGGT|CACGTCGGCAGGGTTGCCCGAAAGGGCGGA
GGCGAAAAGGCCAAGAGGCACGTCGGCAGG|AAATACAGCCCAAACAGCCATGCAGCGATA
AGGGCGTGGGCAGCCGTAAAATACAGCCCA|CGATTGATGGCACGTCGGCAGGGTTGGGCA
GTTGCAAGTCAGCTAAAGCTTGCCGTATAT|AGCGTGATGTGGGTAAGGCACGTCGGCAGG
TCTGTAGTCTTTTCATAGACACTTGAACCT|CGAAATGTCACTGGGCGAATGACGAGAATC
GGGTAGTAGGTGTGATAGTTTCCACCTAGC|GACTGAAAATATCGTGGCTTGGTCACTGCT
TTAACCGAAGGCTGTTACCTGACTGAAAAT|GCGCATTGAATAGGGCCTGTAGCGACTATT
CTGTAGCGACTATTCCCTCCCGTCGGCCAC|TGCGTAAAAGTCGGCACGTCGGCAGGGTTG
CTCGTCCTTAACCGAAGGCTGTTACCTGAC|CGAAAGGGCGCATTGAATAGGGCCTGTAGC
AAAGGGCGGACTACAAATCCCGTAATTAGA|ACCCGTATGGTGGTACGATTGTTATCGCAC
CAACGCCATAACTCGGTCGGTTAGAAAAGG|ACACTTGAACCTTGCTGAGGGAATGTTTGC
CCGAAAGGGCGTGACTCTCTTATTCGGGTC|AGGGTTGCCCGAAAGGCACGTCGGCAGGGT
TCCACCCTATGCGATTGATGGCACGTCGGC|GTTGGCACGTCGGCAGGGTTGCCCGAAAGG
GGCAGGGTTGCCCGAAAGGGCGGCATCGTT|ACGTCGGCAGGGTTGCCCGAAAGGGCGAGT
GTTGCCCGAAAGGGCGCCCGAAAGGGCGAA|TAGACTCAGCTTGTGAGGTGGTATAGACTA
GGTTGCCCGAAAGGGCGAAATGTCACTGGG|CCCCGGACTTATGCGCAGATTGTGGCTAGG
CAGGGTTGCCCGAAAGGCACGTCGGCAGGG|GATACTTACAAGGTTCCGAACACGCAACAA
CGTGGCTTGGTCACTGCTCGGCACGTCGGC|CTCCCGTCGGCCACGATATACGGAACCCTG
AAGGGCGAATGGATGTTGCAAGTCAGCTAA|TATAGACTAGCACAAGCGTGATGTGGGTAA
GCACGTCGGCAGGGTTGCCCGAAAGGGCGA|TGTCGGAGTATACCCCGGACTTATGCGCAG
CAGCTTCCTGATCCCCCATGTCGGAGTATA|GCACGTCGGCAGGGTTGCCCGAAAGGGCGG
GGCGGGTCAACAGACATGACCGGCACGTCG|GTTTGGGCACGTCGGCAGGGTTGCCCGAAA
AGGGCGAGTGGGCACGTCGGCAGGGTTGCC|GTCCGTTTCGTTTAACGGGTTTCGGGAGGG
GTCACTGGGCGAATGACGAGAATCCTTTCC|GTGGCTAGGTCTCCACGAACCTCGTCCTTA
CCCCCATGTCGGAGTATACCCCGGACTTAT|GGTTGCCCGAAAGGGCGGGACAGGGACTGC
ATACCCCGGACTTATGCGCAGATTGTGGCT|CGGGACAGGGACTGCAAACTCCTAGGCACG
GGGCGAGTGGGCACGTCGGCAGGGTTGCCC|TCCGTTTCGTTTAACGGGTTTCGGGAGGGA
GGTTGCCCGAAAGGGCGGGGCGCTATCGAG|AACTCCGGCGAAGCTTATAACTCATTAGTA
GACTACAAATCCCGTAATTAGACTCAGCTT|GGTGGTACGATTGTTATCGCACCAGAGTGG
CGGTGCGTCCGTTTCGTTTAACGGGTTTCG|TGATAGTTTCCACCTAGCCACAGCTTCCTG
CCCGAAAGGGCGTGGGCAGCCGTAAAATAC|CCTATGCGATTGATGGCACGTCGGCAGGGT
CGAATGGATGTTGCAAGTCAGCTAAAGCTT|ACTAGCACAAGCGTGATGTGGGTAAGGCAC
TACAGCCCAAACAGCCATGCAGCGATACTT|GGTTGGGCACGTCGGCAGGGTTGCCCGAAA
CGGGTAGTAGGTGTGATAGTTTCCACCTAG|TGACTGAAAATATCGTGGCTTGGTCACTGC
CTTTGGCGGGCCTGTTGGCACGTCGGCAGG|TTGCCCGAAAGGGCGGCATCGTTTTGACTT
TGGTATAGACTAGCACAAGCGTGATGTGGG|ACAGCTCCGCAACGCCATAACTCGGTCGGT
GGTTGCCCGAAAGGGCGCCCGAAAGGGCGA|TTAGACTCAGCTTGTGAGGTGGTATAGACT
CAAATTATCATGGCGGGTCAACAGACATGA|GGCGCTATCGAGTTTGGGCACGTCGGCAGG
GGCAGGGTTGCCCGAAAGGGCGCTAATCCG|GTTTCGGGAGGGAGGCACGTCGGCAGGGTT
TGTGGCTAGGTCTCCACGAACCTCGTCCTT|AGGCACGTCGGCAGGGTTGCCCGAAAGGGC
TAACTCATTAGTAGTCCAATTATAAGCCAC|AAAGCTTGCCGTATATACTTTGGCGGGCCT
ATAGGGCCTGTAGCGACTATTCCCTCCCGT|TAGCAGGTGCGTAAAAGTCGGCACGTCGGC
TCCCTCCCGTCGGCCACGATATACGGAACC|GCACGTCGGCAGGGTTGCCCGAAAGGGCGT
ACTTATGCGCAGATTGTGGCTAGGTCTCCA|GACTGCAAACTCCTAGGCACGTCGGCAGGG
ATCTCTGTAGTCTTTTCATAGACACTTGAA|GGGCGAAATGTCACTGGGCGAATGACGAGA
GGCGCTAATCCGGTCGGACAATCTCTGTAG|GTCGGCAGGGTTGCCCGAAAGGGCGAAATG
CGACCCGTATGGTGGTACGATTGTTATCGC|GGGTTGCCCGAAAGGGCGCTAATCCGGTCG
TTGCAAGTCAGCTAAAGCTTGCCGTATATA|GCGTGATGTGGGTAAGGCACGTCGGCAGGG
CATTGAATAGGGCCTGTAGCGACTATTCCC|TTTTCGTAGCAGGTGCGTAAAAGTCGGCAC
GCAGGGTTGCCCGAAAGGGCGGACTACAAA|GACTTTGAACGCGACCCGTATGGTGGTACG
TGCCCGAAAGGGCGCTAATCCGGTCGGACA|AGGGAGGCACGTCGGCAGGGTTGCCCGAAA
CGAAAGGGCGAAAAGGCCAAGAGGCACGTC|GCCGTAAAATACAGCCCAAACAGCCATGCA
TTAGACTCAGCTTGTGAGGTGGTATAGACT|CGCACCAGAGTGGCCTTTTACAGCTCCGCA
AGTCAGCTAAAGCTTGCCGTATATACTTTG|ATGTGGGTAAGGCACGTCGGCAGGGTTGCC
TGCCCGAAAGGGCGTGACTCTCTTATTCGG|GGCAGGGTTGCCCGAAAGGCACGTCGGCAG
GCAGGGTTGCCCGAAAGGGCGCTAATCCGG|TTTCGGGAGGGAGGCACGTCGGCAGGGTTG
TAGACTCAGCTTGTGAGGTGGTATAGACTA|GCACCAGAGTGGCCTTTTACAGCTCCGCAA
AGGCCAAGAGGCACGTCGGCAGGGTTGCCC|GCCCAAACAGCCATGCAGCGATACTTACAA
GCACGTCGGCAGGGTTGCCCGAAAGGGCGC|CAAATCCCGTAATTAGACTCAGCTTGTGAG
CCGAAAGGGCGAGTGGGCACGTCGGCAGGG|GGTGCGTCCGTTTCGTTTAACGGGTTTCGG
GATTGTTATCGCACCAGAGTGGCCTTTTAC|CTAATCCGGTCGGACAATCTCTGTAGTCTT
GGGCGTGGGCAGCCGTAAAATACAGCCCAA|GATTGATGGCACGTCGGCAGGGTTGGGCAC
CACGTCGGCAGGGTTGCCCGAAAGGGCGAA|GTCGGAGTATACCCCGGACTTATGCGCAGA
CAGGGTTGCCCGAAAGGGCGGACTACAAAT|ACTTTGAACGCGACCCGTATGGTGGTACGA
GGCGCATTGAATAGGGCCTGTAGCGACTAT|CAGTTTTTCGTAGCAGGTGCGTAAAAGTCG
CCGCAACGCCATAACTCGGTCGGTTAGAAA|TAGACACTTGAACCTTGCTGAGGGAATGTT
GCGAGTGGGCACGTCGGCAGGGTTGCCCGA|CGTTTCGTTTAACGGGTTTCGGGAGGGAGG
GCTTCCTGATCCCCCATGTCGGAGTATACC|ACGTCGGCAGGGTTGCCCGAAAGGGCGGGA
TTGCCCGAAAGGGCGGGGCGCTATCGAGTT|CTCCGGCGAAGCTTATAACTCATTAGTAGT
AGCCACAGCTTCCTGATCCCCCATGTCGGA|GCTCGGCACGTCGGCAGGGTTGCCCGAAAG
GGGAATGTTTGCACGTTCTCGGATCAACGC|GGACTGCCTATGAGAACGGGTAGTAGGTGT
AGCCACTCCACCCTATGCGATTGATGGCAC|GGGCCTGTTGGCACGTCGGCAGGGTTGCCC
GATACTTACAAGGTTCCGAACACGCAACAA|CCCGAAAGGGCGCCCGAAAGGGCGAATGGA
CGGCCACGATATACGGAACCCTGCGCGGCC|AGGGTTGCCCGAAAGGGCGTCGGTTTAATG
TATACCCCGGACTTATGCGCAGATTGTGGC|GCGGGACAGGGACTGCAAACTCCTAGGCAC
CGTCGGCAGGGTTGCCCGAAAGGGCGAAAT|CGGAGTATACCCCGGACTTATGCGCAGATT
ACTGGGCGAATGACGAGAATCCTTTCCGGA|GCTAGGTCTCCACGAACCTCGTCCTTAACC
CGTATGGTGGTACGATTGTTATCGCACCAG|GCCCGAAAGGGCGCTAATCCGGTCGGACAA
GCCAAATTATCATGGCGGGTCAACAGACAT|GGGGCGCTATCGAGTTTGGGCACGTCGGCA
AGTTAAAATGTGTGGCACGTCGGCAGGGTT|GAAAGGGCGAAAAGGCCAAGAGGCACGTCG
TAACTCGGTCGGTTAGAAAAGGGCACGTCG|ACCTTGCTGAGGGAATGTTTGCACGTTCTC
TCGGCACGTCGGCAGGGTTGCCCGAAAGGG|ATACGGAACCCTGCGCGGCCGGCCGCCGAT
GCGATACTTACAAGGTTCCGAACACGCAAC|TGCCCGAAAGGGCGCCCGAAAGGGCGAATG
TAGCGACTATTCCCTCCCGTCGGCCACGAT|GTAAAAGTCGGCACGTCGGCAGGGTTGCCC
GGTTGCCCGAAAGGCACGTCGGCAGGGTTG|ACTTACAAGGTTCCGAACACGCAACAACTC
CCAATTATAAGCCACTCCACCCTATGCGAT|TACTTTGGCGGGCCTGTTGGCACGTCGGCA
AATCCTTTCCGGACTGCCTATGAGAACGGG|CTCGTCCTTAACCGAAGGCTGTTACCTGAC
ATAGACACTTGAACCTTGCTGAGGGAATGT|GCGAATGACGAGAATCCTTTCCGGACTGCC
CTCGGCACGTCGGCAGGGTTGCCCGAAAGG|TATACGGAACCCTGCGCGGCCGGCCGCCGA
GAGTTTGGGCACGTCGGCAGGGTTGCCCGA|GTAGTCCAATTATAAGCCACTCCACCCTAT
ATCCCGTAATTAGACTCAGCTTGTGAGGTG|GATTGTTATCGCACCAGAGTGGCCTTTTAC
GGGTTGCCCGAAAGGGCGGGACAGGGACTG|GCGGCCGGCCGCCGATGGACGGAGAATGTG
TCGGCAGGGTTGCCCGAAAGGGCGCTAATC|GGGTTTCGGGAGGGAGGCACGTCGGCAGGG
AGAAAAGGGCACGTCGGCAGGGTTGCCCGA|ATGTTTGCACGTTCTCGGATCAACGCGGTG
GGGTTGCCCGAAAGGGCGCTAATCCGGTCG|CGGGAGGGAGGCACGTCGGCAGGGTTGCCC
CCGGCGAAGCTTATAACTCATTAGTAGTCC|TTGCAAGTCAGCTAAAGCTTGCCGTATATA
AAGGCACGTCGGCAGGGTTGCCCGAAAGGG|AGAAAAGGGCACGTCGGCAGGGTTGCCCGA
GGCAGGGTTGCCCGAAAGGGCGGGGCGCTA|GCAACAACTCCGGCGAAGCTTATAACTCAT
GCAGGGTTGCCCGAAAGGGCGGCATCGTTT|CGTCGGCAGGGTTGCCCGAAAGGGCGAGTG
AACAGCCATGCAGCGATACTTACAAGGTTC|CGTCGGCAGGGTTGCCCGAAAGGGCGCCCG
ACGTCGGCAGGGTTGCCCGAAAGGGCGCTA|AACGGGTTTCGGGAGGGAGGCACGTCGGCA
GTAGCGACTATTCCCTCCCGTCGGCCACGA|CGTAAAAGTCGGCACGTCGGCAGGGTTGCC
TCGGCAGGGTTGCCCGAAAGGGCGTGACTC|GAGGCACGTCGGCAGGGTTGCCCGAAAGGC
ACAGCTCCGCAACGCCATAACTCGGTCGGT|TTTTCATAGACACTTGAACCTTGCTGAGGG
CTTTCCGGACTGCCTATGAGAACGGGTAGT|TCCTTAACCGAAGGCTGTTACCTGACTGAA
CTGTTACCTGACTGAAAATATCGTGGCTTG|AGGGCCTGTAGCGACTATTCCCTCCCGTCG
GTCGGCAGGGTTGCCCGAAAGGGCGGGACA|ACCCTGCGCGGCCGGCCGCCGATGGACGGA
GGGCGGCATCGTTTTGACTTTGAACGCGAC|CGAAAGGGCGAGTGGGCACGTCGGCAGGGT
GCCGTATATACTTTGGCGGGCCTGTTGGCA|GTCGGCAGGGTTGCCCGAAAGGGCGGCATC
