AAAACGAATAT -> AAACGAATATG
AAAAGCGACTG -> AAAGCGACTGG
AAAAGCTACAG -> AAAGCTACAGA
AAAATAGGATG -> AAATAGGATGG
AAAATCCCCGC -> AAATCCCCGCT
AAAATGCGTTG -> AAATGCGTTGG
AAACATCCGCT -> AACATCCGCTG
AAACCACGTCC -> AACCACGTCCC
AAACCGTGGAA -> AACCGTGGAAA
AAACCTATCAA -> AACCTATCAAG
AAACGAATATG -> AACGAATATGT
AAACTCCGCCA -> AACTCCGCCAC
AAACTCGAAAG -> AACTCGAAAGG
AAAGATTATGT -> AAGATTATGTC
AAAGCAGATTT -> AAGCAGATTTA
AAAGCGAATGA -> AAGCGAATGAT
AAAGCGACTGG -> AAGCGACTGGT
AAAGCGGGAAA -> AAGCGGGAAAA
AAAGCTACAGA -> AAGCTACAGAA
AAAGGCTTATC -> AAGGCTTATCA
AAAGGGCTACA -> AAGGGCTACAT
AAAGTTCGAAA -> AAGTTCGAAAC
AAAGTTGTGGG -> AAGTTGTGGGG
AAATAAATTCG -> AATAAATTCGA
AAATAGGATGG -> AATAGGATGGT
AAATCCCCGCT -> AATCCCCGCTT
AAATGCGTTGG -> AATGCGTTGGT
AAATTCGATGT -> AATTCGATGTG
AACAACGGGCA -> ACAACGGGCAT
AACAACGTTCC -> ACAACGTTCCA
AACAAGTGGAG -> ACAAGTGGAGC
AACAATCCAAT -> ACAATCCAATA
AACACGGAGGC -> ACACGGAGGCT
AACACGGCTTG -> ACACGGCTTGT
AACATAGTTCC -> ACATAGTTCCG
AACATCCGCTG -> ACATCCGCTGC
AACATTGCAAC -> ACATTGCAACT
AACCACGTCCC -> ACCACGTCCCG
AACCATTACCG -> ACCATTACCGA
AACCCCTTTCA -> ACCCCTTTCAT
AACCGACTCCC -> ACCGACTCCCT
AACCGCACACT -> ACCGCACACTT
AACCGCGTAAC -> ACCGCGTAACA
AACCGTGGAAA -> ACCGTGGAAAA
AACCTATCAAG -> ACCTATCAAGG
AACCTGGAGTT -> ACCTGGAGTTC
AACGAATATGT -> ACGAATATGTG
AACGACCTGAG -> ACGACCTGAGC
AACGCCTCCAC -> ACGCCTCCACG
AACGCCTTAGT -> ACGCCTTAGTC
AACGGGCATGC -> ACGGGCATGCT
AACGTCTGCGG -> ACGTCTGCGGC
AACGTGATAAC -> ACGTGATAACA
AACGTTCCAAT -> ACGTTCCAATC
AACTCCGCCAC -> ACTCCGCCACT
AACTCCTCCCA -> ACTCCTCCCAG
AACTCGAAAGG -> ACTCGAAAGGC
AACTCGGCCCA -> ACTCGGCCCAG
AACTCGGTTCG -> ACTCGGTTCGT
AACTGAAGACA -> ACTGAAGACAG
AACTGACCAGA -> ACTGACCAGAC
AACTTGCCGCT -> ACTTGCCGCTG
AAGACAGCCAT -> AGACAGCCATG
AAGAGGATGAT -> AGAGGATGATT
AAGATGGAGAT -> AGATGGAGATT
AAGATTATGTC -> AGATTATGTCA
AAGATTTACGT -> AGATTTACGTT
AAGCAGATTTA -> AGCAGATTTAT
AAGCGAATGAT -> AGCGAATGATC
AAGCGACTGGT -> AGCGACTGGTC
AAGCGGCTTCT -> AGCGGCTTCTC
AAGCGGGAAAA -> AGCGGGAAAAT
AAGCTACAGAA -> AGCTACAGAAT
AAGGCACCACC -> AGGCACCACCC
AAGGCCCAAAG -> AGGCCCAAAGC
AAGGCTCAAGT -> AGGCTCAAGTA
AAGGCTTATCA -> AGGCTTATCAC
AAGGGCTACAT -> AGGGCTACATA
AAGGGTCTCCT -> AGGGTCTCCTG
AAGGGTTAAGT -> AGGGTTAAGTT
AAGGTTAAGTA -> AGGTTAAGTAC
AAGGTTGAGCA -> AGGTTGAGCAG
AAGTACTCAGC -> AGTACTCAGCA
AAGTATTTTTC -> AGTATTTTTCT
AAGTGATTGCA -> AGTGATTGCAG
AAGTGGAGCTC -> AGTGGAGCTCT
AAGTGGTCAAG -> AGTGGTCAAGG
AAGTGTCACGC -> AGTGTCACGCG
AAGTTCGAAAC -> AGTTCGAAACC
AAGTTGAACCG -> AGTTGAACCGC
AAGTTGTGGGG -> AGTTGTGGGGG
AATAAATTCGA -> ATAAATTCGAT
AATAACGCCTT -> ATAACGCCTTA
AATAATATCGG -> ATAATATCGGC
AATACCCAGTA -> ATACCCAGTAC
AATACGTGATC -> ATACGTGATCA
AATAGATGCCC -> ATAGATGCCCG
AATAGCCCACT -> ATAGCCCACTG
AATAGGATGGT -> ATAGGATGGTA
AATATCGGCAA -> ATATCGGCAAG
AATATGTGTCC -> ATATGTGTCCA
AATCCAATACC -> ATCCAATACCC
AATCCCCGCTT -> ATCCCCGCTTC
AATCCGCGGCC -> ATCCGCGGCCC
AATCTGCCATA -> ATCTGCCATAC
AATCTTCAACT -> ATCTTCAACTT
AATCTTTCGCA -> ATCTTTCGCAA
AATGATCGATA -> ATGATCGATAG
AATGCGTTGGT -> ATGCGTTGGTC
AATGTGGGAGT -> ATGTGGGAGTC
AATGTTGAGCG -> ATGTTGAGCGA
AATTCGATGTG -> ATTCGATGTGC
AATTTACCGTG -> ATTTACCGTGC
ACAACAATCCA -> CAACAATCCAA
ACAACACGGCT -> CAACACGGCTT
ACAACGGGCAT -> CAACGGGCATG
ACAACGTTCCA -> CAACGTTCCAA
ACAAGTGGAGC -> CAAGTGGAGCT
ACAATCCAATA -> CAATCCAATAC
ACAATGTTGAG -> CAATGTTGAGC
ACAATTTACCG -> CAATTTACCGT
ACACGCGACAA -> CACGCGACAAT
ACACGGAGGCT -> CACGGAGGCTA
ACACGGCTTGT -> CACGGCTTGTA
ACACTATACTA -> CACTATACTAC
ACACTCATAGG -> CACTCATAGGG
ACACTCTGAAC -> CACTCTGAACC
ACACTTAAACA -> CACTTAAACAT
ACAGAATAGAT -> CAGAATAGATG
ACAGCCATGTT -> CAGCCATGTTT
ACAGCTTTTTT -> CAGCTTTTTTG
ACAGTCCCTGA -> CAGTCCCTGAT
ACATAGGGCGA -> CATAGGGCGAG
ACATAGTTCCG -> CATAGTTCCGG
ACATCCGCTGC -> CATCCGCTGCC
ACATGTTTGTG -> CATGTTTGTGA
ACATTCCAGTT -> CATTCCAGTTA
ACATTGCAACT -> CATTGCAACTC
ACCAAACTCGA -> CCAAACTCGAA
ACCAAGGGTCT -> CCAAGGGTCTC
ACCACCCCGGC -> CCACCCCGGCT
ACCACGGCGTG -> CCACGGCGTGT
ACCACGTCCCG -> CCACGTCCCGC
ACCAGACACTC -> CCAGACACTCA
ACCAGTAATCC -> CCAGTAATCCG
ACCATGGGTTA -> CCATGGGTTAG
ACCATTACCGA -> CCATTACCGAT
ACCCAAAGTTC -> CCCAAAGTTCG
ACCCAGTACGG -> CCCAGTACGGC
ACCCCCCAGCC -> CCCCCCAGCCC
ACCCCGGATGG -> CCCCGGATGGA
ACCCCGGCTAT -> CCCCGGCTATA
ACCCCTTTCAT -> CCCCTTTCATT
ACCCGGGCGTA -> CCCGGGCGTAA
ACCGACTCCCT -> CCGACTCCCTT
ACCGATTAACA -> CCGATTAACAC
ACCGCACACTT -> CCGCACACTTA
ACCGCGTAACA -> CCGCGTAACAA
ACCGGATAATA -> CCGGATAATAA
ACCGTGCAAAC -> CCGTGCAAACT
ACCGTGCCTGC -> CCGTGCCTGCC
ACCGTGGAAAA -> CCGTGGAAAAC
ACCTATCAAGG -> CCTATCAAGGT
ACCTCGAAAGT -> CCTCGAAAGTT
ACCTGAGCTTA -> CCTGAGCTTAA
ACCTGGAGTTC -> CCTGGAGTTCA
ACCTTGTGCCG -> CCTTGTGCCGT
ACGAATATGTG -> CGAATATGTGT
ACGACCTGAGC -> CGACCTGAGCT
ACGAGAGGCAT -> CGAGAGGCATT
ACGAGCAATCT -> CGAGCAATCTT
ACGATTGGTTG -> CGATTGGTTGC
ACGCCGCCCCC -> CGCCGCCCCCA
ACGCCTCCACG -> CGCCTCCACGG
ACGCCTTAGTC -> CGCCTTAGTCT
ACGCGAACGCC -> CGCGAACGCCT
ACGCGACAATG -> CGCGACAATGT
ACGCGCTTTCT -> CGCGCTTTCTG
ACGCGTGAGAA -> CGCGTGAGAAG
ACGCTCAGGCC -> CGCTCAGGCCG
ACGGAGAGCGT -> CGGAGAGCGTA
ACGGAGGCTAC -> CGGAGGCTACG
ACGGAGTCGCG -> CGGAGTCGCGG
ACGGCAGGGCG -> CGGCAGGGCGC
ACGGCGCACGC -> CGGCGCACGCT
ACGGCGTACAC -> CGGCGTACACG
ACGGCGTGTCT -> CGGCGTGTCTG
ACGGCTTGTAC -> CGGCTTGTACT
ACGGCTTTGAT -> CGGCTTTGATC
ACGGGCATGCT -> CGGGCATGCTC
ACGGTACTACG -> CGGTACTACGT
ACGTCCCGCGG -> CGTCCCGCGGG
ACGTCCGATCG -> CGTCCGATCGC
ACGTCTGCGGC -> CGTCTGCGGCG
ACGTGATAACA -> CGTGATAACAA
ACGTGATCAGC -> CGTGATCAGCA
ACGTGCCGAGG -> CGTGCCGAGGT
ACGTGGGTACT -> CGTGGGTACTT
ACGTTCCAATC -> CGTTCCAATCT
ACGTTCGCACA -> CGTTCGCACAG
ACTAAGCGGCT -> CTAAGCGGCTT
ACTACAGTCCC -> CTACAGTCCCT
ACTACCAGTAA -> CTACCAGTAAT
ACTACGAGCAA -> CTACGAGCAAT
ACTACGTGGGT -> CTACGTGGGTA
ACTACTACGAG -> CTACTACGAGC
ACTACTGCAGT -> CTACTGCAGTT
ACTAGGAGCCT -> CTAGGAGCCTC
ACTATACTACC -> CTATACTACCA
ACTATACTTTT -> CTATACTTTTG
ACTATTGATTA -> CTATTGATTAA
ACTCAACGTCT -> CTCAACGTCTG
ACTCACCATGG -> CTCACCATGGG
ACTCAGCATTA -> CTCAGCATTAT
ACTCATAGGGA -> CTCATAGGGAA
ACTCCCTTTGA -> CTCCCTTTGAA
ACTCCGCCACT -> CTCCGCCACTA
ACTCCTCCCAG -> CTCCTCCCAGT
ACTCGAAAGGC -> CTCGAAAGGCT
ACTCGGCCCAG -> CTCGGCCCAGT
ACTCGGTGGAG -> CTCGGTGGAGC
ACTCGGTTCGT -> CTCGGTTCGTG
ACTCTGAACCA -> CTCTGAACCAT
ACTGAAGACAG -> CTGAAGACAGC
ACTGACCAGAC -> CTGACCAGACA
ACTGACTATAC -> CTGACTATACT
ACTGCAGTTTT -> CTGCAGTTTTG
ACTGGTCAACA -> CTGGTCAACAT
ACTGTCCTATC -> CTGTCCTATCC
ACTTAAACATC -> CTTAAACATCC
ACTTCCCCGTA -> CTTCCCCGTAC
ACTTGCCGCTG -> CTTGCCGCTGA
ACTTGGATTTA -> CTTGGATTTAT
ACTTGTACGGA -> CTTGTACGGAG
ACTTTTGATAC -> CTTTTGATACG
AGAAGGTTGAG -> GAAGGTTGAGC
AGAATAGATGC -> GAATAGATGCC
AGACACTCATA -> GACACTCATAG
AGACAGCCATG -> GACAGCCATGT
AGACGCGCTTT -> GACGCGCTTTC
AGACGGCGTAC -> GACGGCGTACA
AGACGTCCGAT -> GACGTCCGATC
AGACTAAGCGG -> GACTAAGCGGC
AGAGACTAAGC -> GAGACTAAGCG
AGAGCCGGCCA -> GAGCCGGCCAG
AGAGCGTAGTA -> GAGCGTAGTAC
AGAGGATGATT -> GAGGATGATTG
AGAGGCATTCC -> GAGGCATTCCG
AGAGGGACATT -> GAGGGACATTC
AGAGTGTGCCA -> GAGTGTGCCAC
AGATAGGGCAT -> GATAGGGCATT
AGATCATTATG -> GATCATTATGG
AGATCTACTCA -> GATCTACTCAC
AGATGCCCGGA -> GATGCCCGGAC
AGATGGAGATT -> GATGGAGATTC
AGATTATGTCA -> GATTATGTCAT
AGATTCTGATG -> GATTCTGATGA
AGATTTACGTT -> GATTTACGTTC
AGATTTATGCG -> GATTTATGCGT
AGCAAAAGCGA -> GCAAAAGCGAC
AGCAAGGCTCA -> GCAAGGCTCAA
AGCAATCTTTC -> GCAATCTTTCG
AGCACACTATA -> GCACACTATAC
AGCAGATTTAT -> GCAGATTTATG
AGCAGTCTTCC -> GCAGTCTTCCG
AGCAGTTAGGC -> GCAGTTAGGCC
AGCATTATATA -> GCATTATATAG
AGCATTTGTGC -> GCATTTGTGCA
AGCCAAAGGGC -> GCCAAAGGGCT
AGCCAGAGACT -> GCCAGAGACTA
AGCCATGTTTC -> GCCATGTTTCG
AGCCCACTGTC -> GCCCACTGTCC
AGCCCTTACTA -> GCCCTTACTAG
AGCCGAGTTTC -> GCCGAGTTTCC
AGCCGGCCAGC -> GCCGGCCAGCT
AGCCTCCACTA -> GCCTCCACTAC
AGCCTTGATAG -> GCCTTGATAGG
AGCGAATGATC -> GCGAATGATCG
AGCGACTGGTC -> GCGACTGGTCA
AGCGAGACGCG -> GCGAGACGCGC
AGCGCGCGAAT -> GCGCGCGAATA
AGCGGCTTCTC -> GCGGCTTCTCG
AGCGGGAAAAT -> GCGGGAAAATG
AGCGGTGGTGC -> GCGGTGGTGCC
AGCGTAGTACT -> GCGTAGTACTA
AGCGTATACGA -> GCGTATACGAG
AGCGTGACCGG -> GCGTGACCGGA
AGCTACAGAAT -> GCTACAGAATA
AGCTCTTATCC -> GCTCTTATCCG
AGCTGCGATCG -> GCTGCGATCGT
AGCTTAAAATA -> GCTTAAAATAG
AGCTTACTATT -> GCTTACTATTG
AGCTTTTTTGG -> GCTTTTTTGGC
AGGAACCGCAC -> GGAACCGCACA
AGGAACTCCTC -> GGAACTCCTCC
AGGACACTCTG -> GGACACTCTGA
AGGACCCCCCA -> GGACCCCCCAG
AGGAGCCTCCA -> GGAGCCTCCAC
AGGATGATTGC -> GGATGATTGCT
AGGATGGTAAC -> GGATGGTAACC
AGGATTCATTT -> GGATTCATTTA
AGGCACCACCC -> GGCACCACCCC
AGGCATTCCGG -> GGCATTCCGGC
AGGCCATTATA -> GGCCATTATAA
AGGCCCAAAGC -> GGCCCAAAGCA
AGGCCGGGTCA -> GGCCGGGTCAA
AGGCTACGATT -> GGCTACGATTG
AGGCTCAAGTA -> GGCTCAAGTAT
AGGCTTATCAC -> GGCTTATCACT
AGGGAAAATCC -> GGGAAAATCCC
AGGGACATTCC -> GGGACATTCCA
AGGGCATTTCA -> GGGCATTTCAG
AGGGCCATATC -> GGGCCATATCG
AGGGCGAGCCA -> GGGCGAGCCAG
AGGGCGCAACT -> GGGCGCAACTC
AGGGCTACATA -> GGGCTACATAG
AGGGGATGATT -> GGGGATGATTA
AGGGTCTCCTG -> GGGTCTCCTGC
AGGGTTAAGTT -> GGGTTAAGTTG
AGGTCAGAGGG -> GGTCAGAGGGA
AGGTCTACGCC -> GGTCTACGCCG
AGGTGCAGTTC -> GGTGCAGTTCT
AGGTGCCATCA -> GGTGCCATCAC
AGGTTAAGTAC -> GGTTAAGTACT
AGGTTAGTCCT -> GGTTAGTCCTC
AGGTTGAGCAG -> GGTTGAGCAGT
AGTAACAACGG -> GTAACAACGGG
AGTAAGAGGAT -> GTAAGAGGATG
AGTAATCCGCG -> GTAATCCGCGG
AGTACGGCTTT -> GTACGGCTTTG
AGTACTACTGC -> GTACTACTGCA
AGTACTCAGCA -> GTACTCAGCAT
AGTATTTTTCT -> GTATTTTTCTC
AGTCCCTGATT -> GTCCCTGATTG
AGTCCGGGCGT -> GTCCGGGCGTG
AGTCCTCCGCG -> GTCCTCCGCGG
AGTCGCGGCAA -> GTCGCGGCAAA
AGTCTTAGGGC -> GTCTTAGGGCC
AGTCTTCCGGC -> GTCTTCCGGCA
AGTGATTGCAG -> GTGATTGCAGA
AGTGGAGCTCT -> GTGGAGCTCTT
AGTGGTCAAGG -> GTGGTCAAGGC
AGTGTCACGCG -> GTGTCACGCGT
AGTGTGCCACG -> GTGTGCCACGG
AGTTAAGGCAC -> GTTAAGGCACC
AGTTAGGCCAT -> GTTAGGCCATT
AGTTCAAAGCG -> GTTCAAAGCGG
AGTTCCGGCAC -> GTTCCGGCACC
AGTTCGAAACC -> GTTCGAAACCG
AGTTCTTAAAC -> GTTCTTAAACC
AGTTGAACATT -> GTTGAACATTG
AGTTGAACCGC -> GTTGAACCGCG
AGTTGGTGCCA -> GTTGGTGCCAT
AGTTGTGGGGG -> GTTGTGGGGGG
AGTTTCCAGGA -> GTTTCCAGGAC
AGTTTTGTTAC -> GTTTTGTTACC
ATAAATTCGAT -> TAAATTCGATG
ATAACAAGTGG -> TAACAAGTGGA
ATAACGCCTTA -> TAACGCCTTAG
ATAACTGAAGA -> TAACTGAAGAC
ATAAGTGTCAC -> TAAGTGTCACG
ATAATAACGCC -> TAATAACGCCT
ATAATATCGGC -> TAATATCGGCA
ATACAACACGG -> TACAACACGGC
ATACCCAGTAC -> TACCCAGTACG
ATACGAGAGGC -> TACGAGAGGCA
ATACGGCGCAC -> TACGGCGCACG
ATACGTGATCA -> TACGTGATCAG
ATACTACCAGT -> TACTACCAGTA
ATACTTTTGAT -> TACTTTTGATA
ATAGATGCCCG -> TAGATGCCCGG
ATAGCCCACTG -> TAGCCCACTGT
ATAGCGTGACC -> TAGCGTGACCG
ATAGCTGCGAT -> TAGCTGCGATC
ATAGGATGGTA -> TAGGATGGTAA
ATAGGGAAAAT -> TAGGGAAAATC
ATAGGGCATTT -> TAGGGCATTTC
ATAGGGCGAGC -> TAGGGCGAGCC
ATAGGGGATGA -> TAGGGGATGAT
ATAGTTCCGGC -> TAGTTCCGGCA
ATATAGCTGCG -> TATAGCTGCGA
ATATCCAGGTC -> TATCCAGGTCA
ATATCGACCCC -> TATCGACCCCG
ATATCGGCAAG -> TATCGGCAAGG
ATATCTCCGTA -> TATCTCCGTAG
ATATGAGCAGT -> TATGAGCAGTC
ATATGTGTCCA -> TATGTGTCCAG
ATATTACCCAA -> TATTACCCAAA
ATATTGGTCCA -> TATTGGTCCAA
ATATTTCCGGG -> TATTTCCGGGC
ATCAAGGTTAA -> TCAAGGTTAAG
ATCAAGTGGTC -> TCAAGTGGTCA
ATCACCAAGGG -> TCACCAAGGGT
ATCACTGACTA -> TCACTGACTAT
ATCAGCAAGGC -> TCAGCAAGGCT
ATCATGGCATA -> TCATGGCATAT
ATCATTATGGC -> TCATTATGGCA
ATCCAATACCC -> TCCAATACCCA
ATCCAGGTCAG -> TCCAGGTCAGA
ATCCCCGCTTC -> TCCCCGCTTCT
ATCCGACGGTA -> TCCGACGGTAC
ATCCGCGGCCC -> TCCGCGGCCCA
ATCCGCTGCCT -> TCCGCTGCCTT
ATCCGGTCCCA -> TCCGGTCCCAT
ATCGACCCCGG -> TCGACCCCGGA
ATCGATAGCGT -> TCGATAGCGTG
ATCGATATTGG -> TCGATATTGGT
ATCGCAACCGA -> TCGCAACCGAC
ATCGCAGCCGA -> TCGCAGCCGAG
ATCGCGATCAA -> TCGCGATCAAG
ATCGGCAAGGG -> TCGGCAAGGGT
ATCGGTGTTAT -> TCGGTGTTATC
ATCGTCCCAAT -> TCGTCCCAATA
ATCGTCGGCAT -> TCGTCGGCATT
ATCTACTCACC -> TCTACTCACCA
ATCTCCGTAGA -> TCTCCGTAGAC
ATCTGCCATAC -> TCTGCCATACA
ATCTTAGGAAC -> TCTTAGGAACC
ATCTTCAACTT -> TCTTCAACTTG
ATCTTTCGCAA -> TCTTTCGCAAC
ATGAACTGACC -> TGAACTGACCA
ATGACAACAAT -> TGACAACAATC
ATGAGCAGTCT -> TGAGCAGTCTT
ATGATCGATAG -> TGATCGATAGC
ATGATTATGTC -> TGATTATGTCG
ATGATTGCTGC -> TGATTGCTGCG
ATGATTTCACC -> TGATTTCACCG
ATGCAGCCTTG -> TGCAGCCTTGA
ATGCCCGGACA -> TGCCCGGACAA
ATGCGATGATT -> TGCGATGATTT
ATGCGTGCGAG -> TGCGTGCGAGA
ATGCGTTGGTC -> TGCGTTGGTCA
ATGCTCGAATG -> TGCTCGAATGT
ATGGAATCTGC -> TGGAATCTGCC
ATGGAGATTCT -> TGGAGATTCTG
ATGGCAAAAGC -> TGGCAAAAGCT
ATGGCATATTT -> TGGCATATTTC
ATGGGTTAGCC -> TGGGTTAGCCA
ATGTCATGCAG -> TGTCATGCAGC
ATGTCGTGCTT -> TGTCGTGCTTC
ATGTCGTTAAA -> TGTCGTTAAAC
ATGTGCGAGAT -> TGTGCGAGATC
ATGTGGGAGTC -> TGTGGGAGTCC
ATGTGTCCAGT -> TGTGTCCAGTA
ATGTTGAGCGA -> TGTTGAGCGAG
ATGTTTCGCCC -> TGTTTCGCCCG
ATGTTTGTGAT -> TGTTTGTGATG
ATTAACACGGA -> TTAACACGGAG
ATTAAGATGGA -> TTAAGATGGAG
ATTACCCAAAG -> TTACCCAAAGT
ATTACCGATTA -> TTACCGATTAA
ATTATAACTGA -> TTATAACTGAA
ATTATATAGCT -> TTATATAGCTG
ATTATGGCAAA -> TTATGGCAAAA
ATTATGTCATG -> TTATGTCATGC
ATTATGTCGTG -> TTATGTCGTGC
ATTCATTTAGG -> TTCATTTAGGA
ATTCCAGTTAA -> TTCCAGTTAAG
ATTCCGGCGCT -> TTCCGGCGCTT
ATTCGAACCCC -> TTCGAACCCCT
ATTCGATGTGC -> TTCGATGTGCG
ATTCTAGGTGC -> TTCTAGGTGCC
ATTCTGATGAA -> TTCTGATGAAC
ATTGATTAAGA -> TTGATTAAGAT
ATTGCAACTCG -> TTGCAACTCGG
ATTGCAGACGT -> TTGCAGACGTC
ATTGCTGCGAC -> TTGCTGCGACC
ATTGGTCCAAC -> TTGGTCCAACG
ATTGGTTGCGC -> TTGGTTGCGCC
ATTGTCAGCGT -> TTGTCAGCGTA
ATTTACCGTGC -> TTTACCGTGCC
ATTTACGTTCG -> TTTACGTTCGC
ATTTAGGACAC -> TTTAGGACACT
ATTTATATCTC -> TTTATATCTCC
ATTTATGCGTG -> TTTATGCGTGC
ATTTCACCGTG -> TTTCACCGTGC
ATTTCAGGTTA -> TTTCAGGTTAG
ATTTCCGGGCT -> TTTCCGGGCTT
ATTTGTGCAGC -> TTTGTGCAGCA
ATTTGTGCAGT -> TTTGTGCAGTT
ATTTTTCTCAT -> TTTTTCTCATA
CAAAAGCGACT -> AAAAGCGACTG
CAAAAGCTACA -> AAAAGCTACAG
CAAACTCCGCC -> AAACTCCGCCA
CAAACTCGAAA -> AAACTCGAAAG
CAAAGATTATG -> AAAGATTATGT
CAAAGCAGATT -> AAAGCAGATTT
CAAAGCGAATG -> AAAGCGAATGA
CAAAGCGGGAA -> AAAGCGGGAAA
CAAAGGGCTAC -> AAAGGGCTACA
CAAAGTTCGAA -> AAAGTTCGAAA
CAACAATCCAA -> AACAATCCAAT
CAACACGGCTT -> AACACGGCTTG
CAACATAGTTC -> AACATAGTTCC
CAACCGACTCC -> AACCGACTCCC
CAACGACCTGA -> AACGACCTGAG
CAACGGGCATG -> AACGGGCATGC
CAACGTCTGCG -> AACGTCTGCGG
CAACGTGATAA -> AACGTGATAAC
CAACGTTCCAA -> AACGTTCCAAT
CAACTCGGCCC -> AACTCGGCCCA
CAACTCGGTTC -> AACTCGGTTCG
CAACTTGCCGC -> AACTTGCCGCT
CAAGATTTACG -> AAGATTTACGT
CAAGGCCCAAA -> AAGGCCCAAAG
CAAGGCTCAAG -> AAGGCTCAAGT
CAAGGGTCTCC -> AAGGGTCTCCT
CAAGGGTTAAG -> AAGGGTTAAGT
CAAGGTTAAGT -> AAGGTTAAGTA
CAAGTATTTTT -> AAGTATTTTTC
CAAGTGGAGCT -> AAGTGGAGCTC
CAAGTGGTCAA -> AAGTGGTCAAG
CAATAATATCG -> AATAATATCGG
CAATACCCAGT -> AATACCCAGTA
CAATCCAATAC -> AATCCAATACC
CAATCTTCAAC -> AATCTTCAACT
CAATCTTTCGC -> AATCTTTCGCA
CAATGTTGAGC -> AATGTTGAGCG
CAATTTACCGT -> AATTTACCGTG
CACACTATACT -> ACACTATACTA
CACACTTAAAC -> ACACTTAAACA
CACAGCTTTTT -> ACAGCTTTTTT
CACCAAACTCG -> ACCAAACTCGA
CACCAAGGGTC -> ACCAAGGGTCT
CACCACCCCGG -> ACCACCCCGGC
CACCATGGGTT -> ACCATGGGTTA
CACCCCGGCTA -> ACCCCGGCTAT
CACCCGGGCGT -> ACCCGGGCGTA
CACCGTGCAAA -> ACCGTGCAAAC
CACGCGAACGC -> ACGCGAACGCC
CACGCGACAAT -> ACGCGACAATG
CACGCGTGAGA -> ACGCGTGAGAA
CACGCTCAGGC -> ACGCTCAGGCC
CACGGAGAGCG -> ACGGAGAGCGT
CACGGAGGCTA -> ACGGAGGCTAC
CACGGCAGGGC -> ACGGCAGGGCG
CACGGCGTGTC -> ACGGCGTGTCT
CACGGCTTGTA -> ACGGCTTGTAC
CACGTCCCGCG -> ACGTCCCGCGG
CACGTGCCGAG -> ACGTGCCGAGG
CACTACAGTCC -> ACTACAGTCCC
CACTACTACGA -> ACTACTACGAG
CACTATACTAC -> ACTATACTACC
CACTCATAGGG -> ACTCATAGGGA
CACTCGGTGGA -> ACTCGGTGGAG
CACTCTGAACC -> ACTCTGAACCA
CACTGACTATA -> ACTGACTATAC
CACTGTCCTAT -> ACTGTCCTATC
CACTTAAACAT -> ACTTAAACATC
CAGAATAGATG -> AGAATAGATGC
CAGACACTCAT -> AGACACTCATA
CAGACGTCCGA -> AGACGTCCGAT
CAGAGACTAAG -> AGAGACTAAGC
CAGAGGGACAT -> AGAGGGACATT
CAGATTTATGC -> AGATTTATGCG
CAGCAAAAGCG -> AGCAAAAGCGA
CAGCAAGGCTC -> AGCAAGGCTCA
CAGCACACTAT -> AGCACACTATA
CAGCATTATAT -> AGCATTATATA
CAGCCATGTTT -> AGCCATGTTTC
CAGCCCTTACT -> AGCCCTTACTA
CAGCCGAGTTT -> AGCCGAGTTTC
CAGCCTTGATA -> AGCCTTGATAG
CAGCGTATACG -> AGCGTATACGA
CAGCTTACTAT -> AGCTTACTATT
CAGCTTTTTTG -> AGCTTTTTTGG
CAGGACCCCCC -> AGGACCCCCCA
CAGGCCGGGTC -> AGGCCGGGTCA
CAGGGCGCAAC -> AGGGCGCAACT
CAGGTCAGAGG -> AGGTCAGAGGG
CAGGTGCAGTT -> AGGTGCAGTTC
CAGGTTAGTCC -> AGGTTAGTCCT
CAGTAACAACG -> AGTAACAACGG
CAGTAAGAGGA -> AGTAAGAGGAT
CAGTAATCCGC -> AGTAATCCGCG
CAGTACGGCTT -> AGTACGGCTTT
CAGTCCCTGAT -> AGTCCCTGATT
CAGTCTTCCGG -> AGTCTTCCGGC
CAGTTAAGGCA -> AGTTAAGGCAC
CAGTTAGGCCA -> AGTTAGGCCAT
CAGTTCTTAAA -> AGTTCTTAAAC
CAGTTGAACAT -> AGTTGAACATT
CAGTTGGTGCC -> AGTTGGTGCCA
CAGTTTTGTTA -> AGTTTTGTTAC
CATAAGTGTCA -> ATAAGTGTCAC
CATACAACACG -> ATACAACACGG
CATAGGGAAAA -> ATAGGGAAAAT
CATAGGGCGAG -> ATAGGGCGAGC
CATAGTTCCGG -> ATAGTTCCGGC
CATATCGACCC -> ATATCGACCCC
CATATGAGCAG -> ATATGAGCAGT
CATATTTCCGG -> ATATTTCCGGG
CATCACCAAGG -> ATCACCAAGGG
CATCCGCTGCC -> ATCCGCTGCCT
CATCGATATTG -> ATCGATATTGG
CATCGTCCCAA -> ATCGTCCCAAT
CATCTTAGGAA -> ATCTTAGGAAC
CATGCAGCCTT -> ATGCAGCCTTG
CATGCTCGAAT -> ATGCTCGAATG
CATGGCATATT -> ATGGCATATTT
CATGGGTTAGC -> ATGGGTTAGCC
CATGTCGTTAA -> ATGTCGTTAAA
CATGTTTCGCC -> ATGTTTCGCCC
CATGTTTGTGA -> ATGTTTGTGAT
CATTACCGATT -> ATTACCGATTA
CATTATAACTG -> ATTATAACTGA
CATTATATAGC -> ATTATATAGCT
CATTATGGCAA -> ATTATGGCAAA
CATTCCAGTTA -> ATTCCAGTTAA
CATTCCGGCGC -> ATTCCGGCGCT
CATTCGAACCC -> ATTCGAACCCC
CATTCTAGGTG -> ATTCTAGGTGC
CATTGCAACTC -> ATTGCAACTCG
CATTTAGGACA -> ATTTAGGACAC
CATTTCAGGTT -> ATTTCAGGTTA
CATTTGTGCAG -> ATTTGTGCAGC,ATTTGTGCAGT
CCAAACTCGAA -> CAAACTCGAAA
CCAAAGCAGAT -> CAAAGCAGATT
CCAAAGGGCTA -> CAAAGGGCTAC
CCAAAGTTCGA -> CAAAGTTCGAA
CCAACGACCTG -> CAACGACCTGA
CCAAGGGTCTC -> CAAGGGTCTCC
CCAATAATATC -> CAATAATATCG
CCAATACCCAG -> CAATACCCAGT
CCAATCTTCAA -> CAATCTTCAAC
CCACCCCGGCT -> CACCCCGGCTA
CCACGCGAACG -> CACGCGAACGC
CCACGGAGAGC -> CACGGAGAGCG
CCACGGCAGGG -> CACGGCAGGGC
CCACGGCGTGT -> CACGGCGTGTC
CCACGTCCCGC -> CACGTCCCGCG
CCACTACAGTC -> CACTACAGTCC
CCACTACTACG -> CACTACTACGA
CCACTCGGTGG -> CACTCGGTGGA
CCACTGTCCTA -> CACTGTCCTAT
CCAGACACTCA -> CAGACACTCAT
CCAGAGACTAA -> CAGAGACTAAG
CCAGCACACTA -> CAGCACACTAT
CCAGCCCTTAC -> CAGCCCTTACT
CCAGCTTACTA -> CAGCTTACTAT
CCAGGACCCCC -> CAGGACCCCCC
CCAGGTCAGAG -> CAGGTCAGAGG
CCAGGTGCAGT -> CAGGTGCAGTT
CCAGTAACAAC -> CAGTAACAACG
CCAGTAAGAGG -> CAGTAAGAGGA
CCAGTAATCCG -> CAGTAATCCGC
CCAGTACGGCT -> CAGTACGGCTT
CCAGTTAAGGC -> CAGTTAAGGCA
CCAGTTGGTGC -> CAGTTGGTGCC
CCATACAACAC -> CATACAACACG
CCATATCGACC -> CATATCGACCC
CCATCACCAAG -> CATCACCAAGG
CCATCGATATT -> CATCGATATTG
CCATCGTCCCA -> CATCGTCCCAA
CCATGGGTTAG -> CATGGGTTAGC
CCATGTCGTTA -> CATGTCGTTAA
CCATGTTTCGC -> CATGTTTCGCC
CCATTACCGAT -> CATTACCGATT
CCATTATAACT -> CATTATAACTG
CCCAAAGCAGA -> CCAAAGCAGAT
CCCAAAGTTCG -> CCAAAGTTCGA
CCCAATAATAT -> CCAATAATATC
CCCACTCGGTG -> CCACTCGGTGG
CCCACTGTCCT -> CCACTGTCCTA
CCCAGCACACT -> CCAGCACACTA
CCCAGCCCTTA -> CCAGCCCTTAC
CCCAGTAACAA -> CCAGTAACAAC
CCCAGTACGGC -> CCAGTACGGCT
CCCAGTTGGTG -> CCAGTTGGTGC
CCCATGTCGTT -> CCATGTCGTTA
CCCCAGCACAC -> CCCAGCACACT
CCCCAGCCCTT -> CCCAGCCCTTA
CCCCCAGCACA -> CCCCAGCACAC
CCCCCAGCCCT -> CCCCAGCCCTT
CCCCCCAGCCC -> CCCCCAGCCCT
CCCCGCTTCTG -> CCCGCTTCTGT
CCCCGGATGGA -> CCCGGATGGAA
CCCCGGCTATA -> CCCGGCTATAT
CCCCGTACCAC -> CCCGTACCACG
CCCCTTTCATT -> CCCTTTCATTT
CCCGCGGGGCA -> CCGCGGGGCAC
CCCGCTTCTGT -> CCGCTTCTGTA
CCCGGACAATT -> CCGGACAATTT
CCCGGATGGAA -> CCGGATGGAAT
CCCGGCTATAT -> CCGGCTATATT
CCCGGGCGTAA -> CCGGGCGTAAG
CCCGTACCACG -> CCGTACCACGG
CCCGTTTTTAG -> CCGTTTTTAGG
CCCTCCACGCG -> CCTCCACGCGA
CCCTGATTGTC -> CCTGATTGTCA
CCCTTACTAGG -> CCTTACTAGGA
CCCTTTCATTT -> CCTTTCATTTG
CCCTTTGAATA -> CCTTTGAATAG
CCGACGGTACT -> CGACGGTACTA
CCGACTCCCTT -> CGACTCCCTTT
CCGAGGTCTAC -> CGAGGTCTACG
CCGAGTTTCCA -> CGAGTTTCCAG
CCGATATCCAG -> CGATATCCAGG
CCGATCGCAAC -> CGATCGCAACC
CCGATTAACAC -> CGATTAACACG
CCGCACACTTA -> CGCACACTTAA
CCGCCACTACA -> CGCCACTACAG
CCGCCCCCAGC -> CGCCCCCAGCA
CCGCCGCGCGG -> CGCCGCGCGGG
CCGCGCGGGAG -> CGCGCGGGAGA
CCGCGGATCGC -> CGCGGATCGCA
CCGCGGCCCAC -> CGCGGCCCACT
CCGCGGGGCAC -> CGCGGGGCACG
CCGCGTAACAA -> CGCGTAACAAC
CCGCTGAGCGC -> CGCTGAGCGCG
CCGCTGCCTTA -> CGCTGCCTTAT
CCGCTTCTGTA -> CGCTTCTGTAG
CCGGACAATTT -> CGGACAATTTA
CCGGATAATAA -> CGGATAATAAC
CCGGATGGAAT -> CGGATGGAATC
CCGGCACCAAA -> CGGCACCAAAC
CCGGCATAAGT -> CGGCATAAGTG
CCGGCCAGCTT -> CGGCCAGCTTA
CCGGCGCTTTA -> CGGCGCTTTAA
CCGGCTATATT -> CGGCTATATTA
CCGGGCGTAAG -> CGGGCGTAAGT
CCGGGCGTGCG -> CGGGCGTGCGA
CCGGGCTTACT -> CGGGCTTACTT
CCGGGTCAAAG -> CGGGTCAAAGA
CCGGTCCCATG -> CGGTCCCATGT
CCGGTGCCTTT -> CGGTGCCTTTG
CCGTACCACGG -> CGTACCACGGC
CCGTAGACGGC -> CGTAGACGGCG
CCGTCGTTGAG -> CGTCGTTGAGA
CCGTGCAAACT -> CGTGCAAACTC
CCGTGCCTGCC -> CGTGCCTGCCG
CCGTGGAAAAC -> CGTGGAAAACG
CCGTTTTTAGG -> CGTTTTTAGGA
CCTATCAAGGT -> CTATCAAGGTT
CCTATCCGGTC -> CTATCCGGTCC
CCTCCACGCGA -> CTCCACGCGAA
CCTCCACGGCA -> CTCCACGGCAG
CCTCCACTACT -> CTCCACTACTA
CCTCCCAGTAA -> CTCCCAGTAAC
CCTCCGCGGAT -> CTCCGCGGATC
CCTCGAAAGTT -> CTCGAAAGTTG
CCTGAGCTTAA -> CTGAGCTTAAA
CCTGATTGTCA -> CTGATTGTCAG
CCTGCCGGTGC -> CTGCCGGTGCC
CCTGCGAGGAT -> CTGCGAGGATT
CCTGGAGTTCA -> CTGGAGTTCAA
CCTTACTAGGA -> CTTACTAGGAG
CCTTAGTCTTA -> CTTAGTCTTAG
CCTTATCGGTG -> CTTATCGGTGT
CCTTGATAGGG -> CTTGATAGGGG
CCTTGTGCCGT -> CTTGTGCCGTC
CCTTTCATTTG -> CTTTCATTTGT
CCTTTGAATAG -> CTTTGAATAGC
CCTTTGCTGCA -> CTTTGCTGCAT
CGAAACCGTGG -> GAAACCGTGGA
CGAAAGGCTTA -> GAAAGGCTTAT
CGAAAGTTGTG -> GAAAGTTGTGG
CGAACCCCTTT -> GAACCCCTTTC
CGAACCTGGAG -> GAACCTGGAGT
CGAACGCCTCC -> GAACGCCTCCA
CGAATACGTGA -> GAATACGTGAT
CGAATATGTGT -> GAATATGTGTC
CGAATGATCGA -> GAATGATCGAT
CGAATGTGGGA -> GAATGTGGGAG
CGACAATGTTG -> GACAATGTTGA
CGACCCCGGAT -> GACCCCGGATG
CGACCTGAGCT -> GACCTGAGCTT
CGACCTTGTGC -> GACCTTGTGCC
CGACGGTACTA -> GACGGTACTAC
CGACTCCCTTT -> GACTCCCTTTG
CGACTGGTCAA -> GACTGGTCAAC
CGAGACGCGCT -> GAGACGCGCTT
CGAGAGGCATT -> GAGAGGCATTC
CGAGATAGGGC -> GAGATAGGGCA
CGAGATCTACT -> GAGATCTACTC
CGAGCAATCTT -> GAGCAATCTTT
CGAGCCAGAGA -> GAGCCAGAGAC
CGAGGATTCAT -> GAGGATTCATT
CGAGGTCTACG -> GAGGTCTACGC
CGAGTTTCCAG -> GAGTTTCCAGG
CGATAGCGTGA -> GATAGCGTGAC
CGATATCCAGG -> GATATCCAGGT
CGATATTGGTC -> GATATTGGTCC
CGATCAAGTGG -> GATCAAGTGGT
CGATCGCAACC -> GATCGCAACCG
CGATCGTCGGC -> GATCGTCGGCA
CGATGATTTCA -> GATGATTTCAC
CGATGCGATGA -> GATGCGATGAT
CGATGTGCGAG -> GATGTGCGAGA
CGATTAACACG -> GATTAACACGG
CGATTGGTTGC -> GATTGGTTGCG
CGCAACCGACT -> GCAACCGACTC
CGCAACGTGAT -> GCAACGTGATA
CGCAACTCGGT -> GCAACTCGGTT
CGCACACTTAA -> GCACACTTAAA
CGCACAGCTTT -> GCACAGCTTTT
CGCACCCGGGC -> GCACCCGGGCG
CGCACGCTCAG -> GCACGCTCAGG
CGCAGCCGAGT -> GCAGCCGAGTT
CGCCACTACAG -> GCCACTACAGT
CGCCATCGATA -> GCCATCGATAT
CGCCCCCAGCA -> GCCCCCAGCAC
CGCCCGTTTTT -> GCCCGTTTTTA
CGCCGCCCCCA -> GCCGCCCCCAG
CGCCGCGCGGG -> GCCGCGCGGGA
CGCCTCCACGG -> GCCTCCACGGC
CGCCTTAGTCT -> GCCTTAGTCTT
CGCGAACGCCT -> GCGAACGCCTC
CGCGAATACGT -> GCGAATACGTG
CGCGACAATGT -> GCGACAATGTT
CGCGATCAAGT -> GCGATCAAGTG
CGCGCGAATAC -> GCGCGAATACG
CGCGCGGGAGA -> GCGCGGGAGAG
CGCGCTTTCTG -> GCGCTTTCTGC
CGCGGATCGCA -> GCGGATCGCAG
CGCGGCAAAGC -> GCGGCAAAGCG
CGCGGCCCACT -> GCGGCCCACTC
CGCGGGAGAGT -> GCGGGAGAGTG
CGCGGGGCACG -> GCGGGGCACGT
CGCGTAACAAC -> GCGTAACAACG
CGCGTGAGAAG -> GCGTGAGAAGG
CGCTCAGGCCG -> GCTCAGGCCGG
CGCTGAGCGCG -> GCTGAGCGCGC
CGCTGCCTTAT -> GCTGCCTTATC
CGCTTCTGTAG -> GCTTCTGTAGA
CGCTTTAAATA -> GCTTTAAATAA
CGCTTTCTGCA -> GCTTTCTGCAT
CGGACAATTTA -> GGACAATTTAC
CGGAGAGCGTA -> GGAGAGCGTAG
CGGAGGCTACG -> GGAGGCTACGA
CGGAGTCGCGG -> GGAGTCGCGGC
CGGATAATAAC -> GGATAATAACG
CGGATCGCAGC -> GGATCGCAGCC
CGGATGGAATC -> GGATGGAATCT
CGGCAAAGCGA -> GGCAAAGCGAA
CGGCAAGGGTT -> GGCAAGGGTTA
CGGCACCAAAC -> GGCACCAAACT
CGGCAGGGCGC -> GGCAGGGCGCA
CGGCATAAGTG -> GGCATAAGTGT
CGGCATTCGAA -> GGCATTCGAAC
CGGCCAGCTTA -> GGCCAGCTTAC
CGGCCCACTCG -> GGCCCACTCGG
CGGCCCAGTTG -> GGCCCAGTTGG
CGGCGCACCCG -> GGCGCACCCGG
CGGCGCACGCT -> GGCGCACGCTC
CGGCGCTTTAA -> GGCGCTTTAAA
CGGCGTACACG -> GGCGTACACGC
CGGCGTGTCTG -> GGCGTGTCTGT
CGGCTATATTA -> GGCTATATTAC
CGGCTTCTCGA -> GGCTTCTCGAA
CGGCTTGTACT -> GGCTTGTACTT
CGGCTTTGATC -> GGCTTTGATCG
CGGGAAAATGC -> GGGAAAATGCG
CGGGAGAGTGT -> GGGAGAGTGTG
CGGGCATGCTC -> GGGCATGCTCG
CGGGCGTAAGT -> GGGCGTAAGTG
CGGGCGTGCGA -> GGGCGTGCGAT
CGGGCTTACTT -> GGGCTTACTTG
CGGGGCACGTG -> GGGGCACGTGC
CGGGTCAAAGA -> GGGTCAAAGAT
CGGTACTACGT -> GGTACTACGTG
CGGTCCCATGT -> GGTCCCATGTC
CGGTGCCTTTG -> GGTGCCTTTGC
CGGTGGAGCAT -> GGTGGAGCATT
CGGTGGTGCCG -> GGTGGTGCCGC
CGGTGTTATCA -> GGTGTTATCAT
CGGTTCGTGCG -> GGTTCGTGCGT
CGTAACAACGT -> GTAACAACGTT
CGTAAGTGATT -> GTAAGTGATTG
CGTACACGCGA -> GTACACGCGAC
CGTACCACGGC -> GTACCACGGCG
CGTAGACGGCG -> GTAGACGGCGT
CGTAGTACTAC -> GTAGTACTACT
CGTATACGAGA -> GTATACGAGAG
CGTCCCAATAA -> GTCCCAATAAT
CGTCCCGCGGG -> GTCCCGCGGGG
CGTCCGATCGC -> GTCCGATCGCA
CGTCGGCATTC -> GTCGGCATTCG
CGTCGTTGAGA -> GTCGTTGAGAG
CGTCTGCGGCG -> GTCTGCGGCGC
CGTGACATGTT -> GTGACATGTTT
CGTGACCGGAT -> GTGACCGGATA
CGTGAGAAGGT -> GTGAGAAGGTT
CGTGATAACAA -> GTGATAACAAG
CGTGATCAGCA -> GTGATCAGCAA
CGTGCAAACTC -> GTGCAAACTCC
CGTGCCGAGGT -> GTGCCGAGGTC
CGTGCCTGCCG -> GTGCCTGCCGG
CGTGCGAGATA -> GTGCGAGATAG
CGTGCGATGCG -> GTGCGATGCGA
CGTGCGTGACA -> GTGCGTGACAT
CGTGCTTCCGA -> GTGCTTCCGAT
CGTGGAAAACG -> GTGGAAAACGA
CGTGGGTACTT -> GTGGGTACTTG
CGTGTCTGTAC -> GTGTCTGTACT
CGTTAAACCAC -> GTTAAACCACG
CGTTCCAATCT -> GTTCCAATCTT
CGTTCGCACAG -> GTTCGCACAGC
CGTTGAGAGCC -> GTTGAGAGCCG
CGTTGGTCAAG -> GTTGGTCAAGA
CGTTTTTAGGA -> GTTTTTAGGAA
CTAAGCGGCTT -> TAAGCGGCTTC
CTACAGAATAG -> TACAGAATAGA
CTACAGTCCCT -> TACAGTCCCTG
CTACATAGGGC -> TACATAGGGCG
CTACCAGTAAT -> TACCAGTAATC
CTACGAGCAAT -> TACGAGCAATC
CTACGATTGGT -> TACGATTGGTT
CTACGCCGCCC -> TACGCCGCCCC
CTACGTGGGTA -> TACGTGGGTAC
CTACTACGAGC -> TACTACGAGCA
CTACTCACCAT -> TACTCACCATG
CTACTGCAGTT -> TACTGCAGTTT
CTAGGAGCCTC -> TAGGAGCCTCC
CTAGGTGCCAT -> TAGGTGCCATC
CTATACTACCA -> TATACTACCAG
CTATACTTTTG -> TATACTTTTGA
CTATATTACCC -> TATATTACCCA
CTATCAAGGTT -> TATCAAGGTTA
CTATCCGGTCC -> TATCCGGTCCC
CTATTGATTAA -> TATTGATTAAG
CTCAACGTCTG -> TCAACGTCTGC
CTCAAGTATTT -> TCAAGTATTTT
CTCACCATGGG -> TCACCATGGGT
CTCAGCATTAT -> TCAGCATTATA
CTCAGGCCGGG -> TCAGGCCGGGT
CTCATAGGGAA -> TCATAGGGAAA
CTCATATGAGC -> TCATATGAGCA
CTCCACGCGAA -> TCCACGCGAAC
CTCCACGGCAG -> TCCACGGCAGG
CTCCACTACTA -> TCCACTACTAC
CTCCCAGTAAC -> TCCCAGTAACA
CTCCCTTTGAA -> TCCCTTTGAAT
CTCCGCCACTA -> TCCGCCACTAC
CTCCGCGGATC -> TCCGCGGATCG
CTCCGTAGACG -> TCCGTAGACGG
CTCCTCCCAGT -> TCCTCCCAGTA
CTCCTGCGAGG -> TCCTGCGAGGA
CTCGAAAGGCT -> TCGAAAGGCTT
CTCGAAAGTTG -> TCGAAAGTTGT
CTCGAACCTGG -> TCGAACCTGGA
CTCGAATGTGG -> TCGAATGTGGG
CTCGGCCCAGT -> TCGGCCCAGTT
CTCGGTGGAGC -> TCGGTGGAGCA
CTCGGTTCGTG -> TCGGTTCGTGC
CTCTGAACCAT -> TCTGAACCATT
CTCTTATCCGA -> TCTTATCCGAC
CTGAACCATTA -> TGAACCATTAC
CTGAAGACAGC -> TGAAGACAGCC
CTGACCAGACA -> TGACCAGACAC
CTGACTATACT -> TGACTATACTT
CTGAGCGCGCG -> TGAGCGCGCGA
CTGAGCTTAAA -> TGAGCTTAAAA
CTGATGAACTG -> TGATGAACTGA
CTGATTGTCAG -> TGATTGTCAGC
CTGCAGTTTTG -> TGCAGTTTTGT
CTGCATCTTAG -> TGCATCTTAGG
CTGCATTCTAG -> TGCATTCTAGG
CTGCCATACAA -> TGCCATACAAC
CTGCCGGTGCC -> TGCCGGTGCCT
CTGCCTTATCG -> TGCCTTATCGG
CTGCGACCTTG -> TGCGACCTTGT
CTGCGAGGATT -> TGCGAGGATTC
CTGCGATCGTC -> TGCGATCGTCG
CTGCGGCGCAC -> TGCGGCGCACC
CTGGAGTTCAA -> TGGAGTTCAAA
CTGGTCAACAT -> TGGTCAACATA
CTGTACTCAAC -> TGTACTCAACG
CTGTAGATCAT -> TGTAGATCATT
CTGTCCTATCC -> TGTCCTATCCG
CTTAAAATAGG -> TTAAAATAGGA
CTTAAACATCC -> TTAAACATCCG
CTTAAACCTAT -> TTAAACCTATC
CTTACTAGGAG -> TTACTAGGAGC
CTTACTATTGA -> TTACTATTGAT
CTTACTTGTAC -> TTACTTGTACG
CTTAGCGGTGG -> TTAGCGGTGGT
CTTAGGAACCG -> TTAGGAACCGC
CTTAGGGCCAT -> TTAGGGCCATA
CTTAGTCTTAG -> TTAGTCTTAGG
CTTATCACTGA -> TTATCACTGAC
CTTATCCGACG -> TTATCCGACGG
CTTATCGGTGT -> TTATCGGTGTT
CTTCAACTTGC -> TTCAACTTGCC
CTTCCCCGTAC -> TTCCCCGTACC
CTTCCGATATC -> TTCCGATATCC
CTTCCGGCATA -> TTCCGGCATAA
CTTCTCGAACC -> TTCTCGAACCT
CTTCTGTAGAT -> TTCTGTAGATC
CTTGATAGGGG -> TTGATAGGGGA
CTTGCCGCTGA -> TTGCCGCTGAG
CTTGGATTTAT -> TTGGATTTATA
CTTGTACGGAG -> TTGTACGGAGT
CTTGTACTTCC -> TTGTACTTCCC
CTTGTGCCGTC -> TTGTGCCGTCG
CTTTAAATAAA -> TTTAAATAAAT
CTTTCATTTGT -> TTTCATTTGTG
CTTTCGCAACG -> TTTCGCAACGT
CTTTCTGCATC -> TTTCTGCATCT
CTTTGAATAGC -> TTTGAATAGCC
CTTTGATCGCG -> TTTGATCGCGA
CTTTGCTGCAT -> TTTGCTGCATT
CTTTTGATACG -> TTTTGATACGG
CTTTTTTGGCC -> TTTTTTGGCCA
GAAAACGAATA -> AAAACGAATAT
GAAAATCCCCG -> AAAATCCCCGC
GAAAATGCGTT -> AAAATGCGTTG
GAAACCGTGGA -> AAACCGTGGAA
GAAAGGCTTAT -> AAAGGCTTATC
GAAAGTTGTGG -> AAAGTTGTGGG
GAACATTGCAA -> AACATTGCAAC
GAACCATTACC -> AACCATTACCG
GAACCCCTTTC -> AACCCCTTTCA
GAACCGCACAC -> AACCGCACACT
GAACCGCGTAA -> AACCGCGTAAC
GAACCTGGAGT -> AACCTGGAGTT
GAACGCCTCCA -> AACGCCTCCAC
GAACTCCTCCC -> AACTCCTCCCA
GAACTGACCAG -> AACTGACCAGA
GAAGACAGCCA -> AAGACAGCCAT
GAAGGTTGAGC -> AAGGTTGAGCA
GAATACGTGAT -> AATACGTGATC
GAATAGATGCC -> AATAGATGCCC
GAATAGCCCAC -> AATAGCCCACT
GAATATGTGTC -> AATATGTGTCC
GAATCTGCCAT -> AATCTGCCATA
GAATGATCGAT -> AATGATCGATA
GAATGTGGGAG -> AATGTGGGAGT
GACAACAATCC -> ACAACAATCCA
GACAATGTTGA -> ACAATGTTGAG
GACAATTTACC -> ACAATTTACCG
GACACTCATAG -> ACACTCATAGG
GACACTCTGAA -> ACACTCTGAAC
GACAGCCATGT -> ACAGCCATGTT
GACATGTTTGT -> ACATGTTTGTG
GACATTCCAGT -> ACATTCCAGTT
GACCAGACACT -> ACCAGACACTC
GACCCCCCAGC -> ACCCCCCAGCC
GACCCCGGATG -> ACCCCGGATGG
GACCGGATAAT -> ACCGGATAATA
GACCTGAGCTT -> ACCTGAGCTTA
GACCTTGTGCC -> ACCTTGTGCCG
GACGCGCTTTC -> ACGCGCTTTCT
GACGGCGTACA -> ACGGCGTACAC
GACGGTACTAC -> ACGGTACTACG
GACGTCCGATC -> ACGTCCGATCG
GACTAAGCGGC -> ACTAAGCGGCT
GACTATACTTT -> ACTATACTTTT
GACTCCCTTTG -> ACTCCCTTTGA
GACTGGTCAAC -> ACTGGTCAACA
GAGAAGGTTGA -> AGAAGGTTGAG
GAGACGCGCTT -> AGACGCGCTTT
GAGACTAAGCG -> AGACTAAGCGG
GAGAGCCGGCC -> AGAGCCGGCCA
GAGAGCGTAGT -> AGAGCGTAGTA
GAGAGGCATTC -> AGAGGCATTCC
GAGAGTGTGCC -> AGAGTGTGCCA
GAGATAGGGCA -> AGATAGGGCAT
GAGATCTACTC -> AGATCTACTCA
GAGATTCTGAT -> AGATTCTGATG
GAGCAATCTTT -> AGCAATCTTTC
GAGCAGTCTTC -> AGCAGTCTTCC
GAGCAGTTAGG -> AGCAGTTAGGC
GAGCATTTGTG -> AGCATTTGTGC
GAGCCAGAGAC -> AGCCAGAGACT
GAGCCGGCCAG -> AGCCGGCCAGC
GAGCCTCCACT -> AGCCTCCACTA
GAGCGAGACGC -> AGCGAGACGCG
GAGCGCGCGAA -> AGCGCGCGAAT
GAGCGTAGTAC -> AGCGTAGTACT
GAGCTCTTATC -> AGCTCTTATCC
GAGCTTAAAAT -> AGCTTAAAATA
GAGGATGATTG -> AGGATGATTGC
GAGGATTCATT -> AGGATTCATTT
GAGGCATTCCG -> AGGCATTCCGG
GAGGCTACGAT -> AGGCTACGATT
GAGGGACATTC -> AGGGACATTCC
GAGGTCTACGC -> AGGTCTACGCC
GAGTCCGGGCG -> AGTCCGGGCGT
GAGTCGCGGCA -> AGTCGCGGCAA
GAGTGTGCCAC -> AGTGTGCCACG
GAGTTCAAAGC -> AGTTCAAAGCG
GAGTTTCCAGG -> AGTTTCCAGGA
GATAACAAGTG -> ATAACAAGTGG
GATAATAACGC -> ATAATAACGCC
GATACGGCGCA -> ATACGGCGCAC
GATAGCGTGAC -> ATAGCGTGACC
GATAGGGCATT -> ATAGGGCATTT
GATAGGGGATG -> ATAGGGGATGA
GATATCCAGGT -> ATATCCAGGTC
GATATTGGTCC -> ATATTGGTCCA
GATCAAGTGGT -> ATCAAGTGGTC
GATCAGCAAGG -> ATCAGCAAGGC
GATCATTATGG -> ATCATTATGGC
GATCGATAGCG -> ATCGATAGCGT
GATCGCAACCG -> ATCGCAACCGA
GATCGCAGCCG -> ATCGCAGCCGA
GATCGCGATCA -> ATCGCGATCAA
GATCGTCGGCA -> ATCGTCGGCAT
GATCTACTCAC -> ATCTACTCACC
GATGAACTGAC -> ATGAACTGACC
GATGACAACAA -> ATGACAACAAT
GATGATTATGT -> ATGATTATGTC
GATGATTGCTG -> ATGATTGCTGC
GATGATTTCAC -> ATGATTTCACC
GATGCCCGGAC -> ATGCCCGGACA
GATGCGATGAT -> ATGCGATGATT
GATGGAATCTG -> ATGGAATCTGC
GATGGAGATTC -> ATGGAGATTCT
GATGTGCGAGA -> ATGTGCGAGAT
GATTAACACGG -> ATTAACACGGA
GATTAAGATGG -> ATTAAGATGGA
GATTATGTCAT -> ATTATGTCATG
GATTATGTCGT -> ATTATGTCGTG
GATTCATTTAG -> ATTCATTTAGG
GATTCTGATGA -> ATTCTGATGAA
GATTGCAGACG -> ATTGCAGACGT
GATTGCTGCGA -> ATTGCTGCGAC
GATTGGTTGCG -> ATTGGTTGCGC
GATTGTCAGCG -> ATTGTCAGCGT
GATTTACGTTC -> ATTTACGTTCG
GATTTATATCT -> ATTTATATCTC
GATTTATGCGT -> ATTTATGCGTG
GATTTCACCGT -> ATTTCACCGTG
GCAAAAGCGAC -> CAAAAGCGACT
GCAAAAGCTAC -> CAAAAGCTACA
GCAAACTCCGC -> CAAACTCCGCC
GCAAAGCGAAT -> CAAAGCGAATG
GCAACCGACTC -> CAACCGACTCC
GCAACGTGATA -> CAACGTGATAA
GCAACTCGGCC -> CAACTCGGCCC
GCAACTCGGTT -> CAACTCGGTTC
GCAAGGCTCAA -> CAAGGCTCAAG
GCAAGGGTTAA -> CAAGGGTTAAG
GCAATCTTTCG -> CAATCTTTCGC
GCACACTATAC -> CACACTATACT
GCACACTTAAA -> CACACTTAAAC
GCACAGCTTTT -> CACAGCTTTTT
GCACCAAACTC -> CACCAAACTCG
GCACCACCCCG -> CACCACCCCGG
GCACCCGGGCG -> CACCCGGGCGT
GCACGCTCAGG -> CACGCTCAGGC
GCACGTGCCGA -> CACGTGCCGAG
GCAGACGTCCG -> CAGACGTCCGA
GCAGATTTATG -> CAGATTTATGC
GCAGCAAAAGC -> CAGCAAAAGCG
GCAGCCGAGTT -> CAGCCGAGTTT
GCAGCCTTGAT -> CAGCCTTGATA
GCAGGGCGCAA -> CAGGGCGCAAC
GCAGTCTTCCG -> CAGTCTTCCGG
GCAGTTAGGCC -> CAGTTAGGCCA
GCAGTTCTTAA -> CAGTTCTTAAA
GCAGTTGAACA -> CAGTTGAACAT
GCAGTTTTGTT -> CAGTTTTGTTA
GCATAAGTGTC -> CATAAGTGTCA
GCATATTTCCG -> CATATTTCCGG
GCATCTTAGGA -> CATCTTAGGAA
GCATGCTCGAA -> CATGCTCGAAT
GCATTATATAG -> CATTATATAGC
GCATTCCGGCG -> CATTCCGGCGC
GCATTCGAACC -> CATTCGAACCC
GCATTCTAGGT -> CATTCTAGGTG
GCATTTCAGGT -> CATTTCAGGTT
GCATTTGTGCA -> CATTTGTGCAG
GCCAAAGGGCT -> CCAAAGGGCTA
GCCACGGAGAG -> CCACGGAGAGC
GCCACTACAGT -> CCACTACAGTC
GCCAGAGACTA -> CCAGAGACTAA
GCCAGCTTACT -> CCAGCTTACTA
GCCAGGTGCAG -> CCAGGTGCAGT
GCCATACAACA -> CCATACAACAC
GCCATATCGAC -> CCATATCGACC
GCCATCACCAA -> CCATCACCAAG
GCCATCGATAT -> CCATCGATATT
GCCATCGTCCC -> CCATCGTCCCA
GCCATGTTTCG -> CCATGTTTCGC
GCCATTATAAC -> CCATTATAACT
GCCCAAAGCAG -> CCCAAAGCAGA
GCCCACTCGGT -> CCCACTCGGTG
GCCCACTGTCC -> CCCACTGTCCT
GCCCAGTTGGT -> CCCAGTTGGTG
GCCCCCAGCAC -> CCCCCAGCACA
GCCCGGACAAT -> CCCGGACAATT
GCCCGTTTTTA -> CCCGTTTTTAG
GCCCTTACTAG -> CCCTTACTAGG
GCCGAGGTCTA -> CCGAGGTCTAC
GCCGAGTTTCC -> CCGAGTTTCCA
GCCGCCCCCAG -> CCGCCCCCAGC
GCCGCCGCGCG -> CCGCCGCGCGG
GCCGCGCGGGA -> CCGCGCGGGAG
GCCGCTGAGCG -> CCGCTGAGCGC
GCCGGCCAGCT -> CCGGCCAGCTT
GCCGGGTCAAA -> CCGGGTCAAAG
GCCGGTGCCTT -> CCGGTGCCTTT
GCCGTCGTTGA -> CCGTCGTTGAG
GCCTCCACGGC -> CCTCCACGGCA
GCCTCCACTAC -> CCTCCACTACT
GCCTGCCGGTG -> CCTGCCGGTGC
GCCTTAGTCTT -> CCTTAGTCTTA
GCCTTATCGGT -> CCTTATCGGTG
GCCTTGATAGG -> CCTTGATAGGG
GCCTTTGCTGC -> CCTTTGCTGCA
GCGAACGCCTC -> CGAACGCCTCC
GCGAATACGTG -> CGAATACGTGA
GCGAATGATCG -> CGAATGATCGA
GCGACAATGTT -> CGACAATGTTG
GCGACCTTGTG -> CGACCTTGTGC
GCGACTGGTCA -> CGACTGGTCAA
GCGAGACGCGC -> CGAGACGCGCT
GCGAGATAGGG -> CGAGATAGGGC
GCGAGATCTAC -> CGAGATCTACT
GCGAGCCAGAG -> CGAGCCAGAGA
GCGAGGATTCA -> CGAGGATTCAT
GCGATCAAGTG -> CGATCAAGTGG
GCGATCGTCGG -> CGATCGTCGGC
GCGATGATTTC -> CGATGATTTCA
GCGATGCGATG -> CGATGCGATGA
GCGCAACTCGG -> CGCAACTCGGT
GCGCACCCGGG -> CGCACCCGGGC
GCGCACGCTCA -> CGCACGCTCAG
GCGCCATCGAT -> CGCCATCGATA
GCGCGAATACG -> CGCGAATACGT
GCGCGCGAATA -> CGCGCGAATAC
GCGCGGGAGAG -> CGCGGGAGAGT
GCGCTTTAAAT -> CGCTTTAAATA
GCGCTTTCTGC -> CGCTTTCTGCA
GCGGATCGCAG -> CGGATCGCAGC
GCGGCAAAGCG -> CGGCAAAGCGA
GCGGCCCACTC -> CGGCCCACTCG
GCGGCGCACCC -> CGGCGCACCCG
GCGGCTTCTCG -> CGGCTTCTCGA
GCGGGAAAATG -> CGGGAAAATGC
GCGGGAGAGTG -> CGGGAGAGTGT
GCGGGGCACGT -> CGGGGCACGTG
GCGGTGGTGCC -> CGGTGGTGCCG
GCGTAACAACG -> CGTAACAACGT
GCGTAAGTGAT -> CGTAAGTGATT
GCGTACACGCG -> CGTACACGCGA
GCGTAGTACTA -> CGTAGTACTAC
GCGTATACGAG -> CGTATACGAGA
GCGTGACATGT -> CGTGACATGTT
GCGTGACCGGA -> CGTGACCGGAT
GCGTGAGAAGG -> CGTGAGAAGGT
GCGTGCGAGAT -> CGTGCGAGATA
GCGTGCGATGC -> CGTGCGATGCG
GCGTGTCTGTA -> CGTGTCTGTAC
GCGTTGGTCAA -> CGTTGGTCAAG
GCTACAGAATA -> CTACAGAATAG
GCTACATAGGG -> CTACATAGGGC
GCTACGATTGG -> CTACGATTGGT
GCTATATTACC -> CTATATTACCC
GCTCAAGTATT -> CTCAAGTATTT
GCTCAGGCCGG -> CTCAGGCCGGG
GCTCGAATGTG -> CTCGAATGTGG
GCTCTTATCCG -> CTCTTATCCGA
GCTGAGCGCGC -> CTGAGCGCGCG
GCTGCATTCTA -> CTGCATTCTAG
GCTGCCTTATC -> CTGCCTTATCG
GCTGCGACCTT -> CTGCGACCTTG
GCTGCGATCGT -> CTGCGATCGTC
GCTTAAAATAG -> CTTAAAATAGG
GCTTACTATTG -> CTTACTATTGA
GCTTACTTGTA -> CTTACTTGTAC
GCTTATCACTG -> CTTATCACTGA
GCTTCCGATAT -> CTTCCGATATC
GCTTCTCGAAC -> CTTCTCGAACC
GCTTCTGTAGA -> CTTCTGTAGAT
GCTTGTACTTC -> CTTGTACTTCC
GCTTTAAATAA -> CTTTAAATAAA
GCTTTCTGCAT -> CTTTCTGCATC
GCTTTGATCGC -> CTTTGATCGCG
GCTTTTTTGGC -> CTTTTTTGGCC
GGAAAACGAAT -> GAAAACGAATA
GGAAAATCCCC -> GAAAATCCCCG
GGAAAATGCGT -> GAAAATGCGTT
GGAACCGCACA -> GAACCGCACAC
GGAACTCCTCC -> GAACTCCTCCC
GGAATCTGCCA -> GAATCTGCCAT
GGACAATTTAC -> GACAATTTACC
GGACACTCTGA -> GACACTCTGAA
GGACATTCCAG -> GACATTCCAGT
GGACCCCCCAG -> GACCCCCCAGC
GGAGAGCGTAG -> GAGAGCGTAGT
GGAGAGTGTGC -> GAGAGTGTGCC
GGAGATTCTGA -> GAGATTCTGAT
GGAGCATTTGT -> GAGCATTTGTG
GGAGCCTCCAC -> GAGCCTCCACT
GGAGCTCTTAT -> GAGCTCTTATC
GGAGGCTACGA -> GAGGCTACGAT
GGAGTCCGGGC -> GAGTCCGGGCG
GGAGTCGCGGC -> GAGTCGCGGCA
GGAGTTCAAAG -> GAGTTCAAAGC
GGATAATAACG -> GATAATAACGC
GGATCGCAGCC -> GATCGCAGCCG
GGATGATTATG -> GATGATTATGT
GGATGATTGCT -> GATGATTGCTG
GGATGGAATCT -> GATGGAATCTG
GGATGGTAACC -> GATGGTAACCG
GGATTCATTTA -> GATTCATTTAG
GGATTTATATC -> GATTTATATCT
GGCAAAAGCTA -> GCAAAAGCTAC
GGCAAAGCGAA -> GCAAAGCGAAT
GGCAAGGGTTA -> GCAAGGGTTAA
GGCACCAAACT -> GCACCAAACTC
GGCACCACCCC -> GCACCACCCCG
GGCACGTGCCG -> GCACGTGCCGA
GGCAGGGCGCA -> GCAGGGCGCAA
GGCATAAGTGT -> GCATAAGTGTC
GGCATATTTCC -> GCATATTTCCG
GGCATGCTCGA -> GCATGCTCGAA
GGCATTCCGGC -> GCATTCCGGCG
GGCATTCGAAC -> GCATTCGAACC
GGCATTTCAGG -> GCATTTCAGGT
GGCCAGCTTAC -> GCCAGCTTACT
GGCCAGGTGCA -> GCCAGGTGCAG
GGCCATATCGA -> GCCATATCGAC
GGCCATTATAA -> GCCATTATAAC
GGCCCAAAGCA -> GCCCAAAGCAG
GGCCCACTCGG -> GCCCACTCGGT
GGCCCAGTTGG -> GCCCAGTTGGT
GGCCGGGTCAA -> GCCGGGTCAAA
GGCGAGCCAGA -> GCGAGCCAGAG
GGCGCAACTCG -> GCGCAACTCGG
GGCGCACCCGG -> GCGCACCCGGG
GGCGCACGCTC -> GCGCACGCTCA
GGCGCTTTAAA -> GCGCTTTAAAT
GGCGTAAGTGA -> GCGTAAGTGAT
GGCGTACACGC -> GCGTACACGCG
GGCGTGCGATG -> GCGTGCGATGC
GGCGTGTCTGT -> GCGTGTCTGTA
GGCTACATAGG -> GCTACATAGGG
GGCTACGATTG -> GCTACGATTGG
GGCTATATTAC -> GCTATATTACC
GGCTCAAGTAT -> GCTCAAGTATT
GGCTTACTTGT -> GCTTACTTGTA
GGCTTATCACT -> GCTTATCACTG
GGCTTCTCGAA -> GCTTCTCGAAC
GGCTTGTACTT -> GCTTGTACTTC
GGCTTTGATCG -> GCTTTGATCGC
GGGAAAATCCC -> GGAAAATCCCC
GGGAAAATGCG -> GGAAAATGCGT
GGGACATTCCA -> GGACATTCCAG
GGGAGAGTGTG -> GGAGAGTGTGC
GGGAGTCCGGG -> GGAGTCCGGGC
GGGATGATTAT -> GGATGATTATG
GGGCACGTGCC -> GGCACGTGCCG
GGGCATGCTCG -> GGCATGCTCGA
GGGCATTTCAG -> GGCATTTCAGG
GGGCCATATCG -> GGCCATATCGA
GGGCGAGCCAG -> GGCGAGCCAGA
GGGCGCAACTC -> GGCGCAACTCG
GGGCGTAAGTG -> GGCGTAAGTGA
GGGCGTGCGAT -> GGCGTGCGATG
GGGCTACATAG -> GGCTACATAGG
GGGCTTACTTG -> GGCTTACTTGT
GGGGATGATTA -> GGGATGATTAT
GGGGCACGTGC -> GGGCACGTGCC
GGGGGGTCCCT -> GGGGGTCCCTC
GGGGGTCCCTC -> GGGGTCCCTCC
GGGGTCCCTCC -> GGGTCCCTCCA
GGGTACTTGGA -> GGTACTTGGAT
GGGTCAAAGAT -> GGTCAAAGATT
GGGTCCCTCCA -> GGTCCCTCCAC
GGGTCTCCTGC -> GGTCTCCTGCG
GGGTTAAGTTG -> GGTTAAGTTGA
GGGTTAGCCAA -> GGTTAGCCAAA
GGTACTACGTG -> GTACTACGTGG
GGTACTTGGAT -> GTACTTGGATT
GGTCAAAGATT -> GTCAAAGATTA
GGTCAACATAG -> GTCAACATAGT
GGTCAAGATTT -> GTCAAGATTTA
GGTCAAGGCCC -> GTCAAGGCCCA
GGTCAGAGGGA -> GTCAGAGGGAC
GGTCCAACGAC -> GTCCAACGACC
GGTCCCATGTC -> GTCCCATGTCG
GGTCCCTCCAC -> GTCCCTCCACG
GGTCTACGCCG -> GTCTACGCCGC
GGTCTCCTGCG -> GTCTCCTGCGA
GGTGCAGTTCT -> GTGCAGTTCTT
GGTGCCATCAC -> GTGCCATCACC
GGTGCCATCGT -> GTGCCATCGTC
GGTGCCGCCGC -> GTGCCGCCGCG
GGTGCCTTTGC -> GTGCCTTTGCT
GGTGGAGCATT -> GTGGAGCATTT
GGTGGTGCCGC -> GTGGTGCCGCC
GGTGTTATCAT -> GTGTTATCATG
GGTTAAGTACT -> GTTAAGTACTC
GGTTAAGTTGA -> GTTAAGTTGAA
GGTTAGCCAAA -> GTTAGCCAAAG
GGTTAGTCCTC -> GTTAGTCCTCC
GGTTCGTGCGT -> GTTCGTGCGTG
GGTTGAGCAGT -> GTTGAGCAGTT
GGTTGCGCCAT -> GTTGCGCCATC
GTAACAACGGG -> TAACAACGGGC
GTAACAACGTT -> TAACAACGTTC
GTAAGAGGATG -> TAAGAGGATGA
GTAAGTGATTG -> TAAGTGATTGC
GTAATCCGCGG -> TAATCCGCGGC
GTACACGCGAC -> TACACGCGACA
GTACCACGGCG -> TACCACGGCGT
GTACGGAGTCG -> TACGGAGTCGC
GTACGGCTTTG -> TACGGCTTTGA
GTACTACGTGG -> TACTACGTGGG
GTACTACTGCA -> TACTACTGCAG
GTACTCAACGT -> TACTCAACGTC
GTACTCAGCAT -> TACTCAGCATT
GTACTTCCCCG -> TACTTCCCCGT
GTACTTGGATT -> TACTTGGATTT
GTAGACGGCGT -> TAGACGGCGTA
GTAGATCATTA -> TAGATCATTAT
GTAGTACTACT -> TAGTACTACTG
GTATACGAGAG -> TATACGAGAGG
GTATTTTTCTC -> TATTTTTCTCA
GTCAAAGATTA -> TCAAAGATTAT
GTCAACATAGT -> TCAACATAGTT
GTCAAGATTTA -> TCAAGATTTAC
GTCAAGGCCCA -> TCAAGGCCCAA
GTCACGCGTGA -> TCACGCGTGAG
GTCAGAGGGAC -> TCAGAGGGACA
GTCAGCGTATA -> TCAGCGTATAC
GTCATGCAGCC -> TCATGCAGCCT
GTCCAACGACC -> TCCAACGACCT
GTCCAGTAAGA -> TCCAGTAAGAG
GTCCCAATAAT -> TCCCAATAATA
GTCCCATGTCG -> TCCCATGTCGT
GTCCCGCGGGG -> TCCCGCGGGGC
GTCCCTCCACG -> TCCCTCCACGC
GTCCCTGATTG -> TCCCTGATTGT
GTCCGATCGCA -> TCCGATCGCAA
GTCCGGGCGTG -> TCCGGGCGTGC
GTCCTATCCGG -> TCCTATCCGGT
GTCCTCCGCGG -> TCCTCCGCGGA
GTCGCGGCAAA -> TCGCGGCAAAG
GTCGGCATTCG -> TCGGCATTCGA
GTCGTGCTTCC -> TCGTGCTTCCG
GTCGTTAAACC -> TCGTTAAACCA
GTCGTTGAGAG -> TCGTTGAGAGC
GTCTACGCCGC -> TCTACGCCGCC
GTCTCCTGCGA -> TCTCCTGCGAG
GTCTGCGGCGC -> TCTGCGGCGCA
GTCTGTACTCA -> TCTGTACTCAA
GTCTTAGGGCC -> TCTTAGGGCCA
GTCTTCCGGCA -> TCTTCCGGCAT
GTGACATGTTT -> TGACATGTTTG
GTGACCGGATA -> TGACCGGATAA
GTGAGAAGGTT -> TGAGAAGGTTG
GTGATAACAAG -> TGATAACAAGT
GTGATCAGCAA -> TGATCAGCAAG
GTGATGACAAC -> TGATGACAACA
GTGATTGCAGA -> TGATTGCAGAC
GTGCAAACTCC -> TGCAAACTCCG
GTGCAGCAAAA -> TGCAGCAAAAG
GTGCAGTTCTT -> TGCAGTTCTTA
GTGCAGTTGAA -> TGCAGTTGAAC
GTGCCACGGAG -> TGCCACGGAGA
GTGCCATCACC -> TGCCATCACCA
GTGCCATCGTC -> TGCCATCGTCC
GTGCCGAGGTC -> TGCCGAGGTCT
GTGCCGCCGCG -> TGCCGCCGCGC
GTGCCGTCGTT -> TGCCGTCGTTG
GTGCCTGCCGG -> TGCCTGCCGGT
GTGCCTTTGCT -> TGCCTTTGCTG
GTGCGAGATAG -> TGCGAGATAGG
GTGCGAGATCT -> TGCGAGATCTA
GTGCGATGCGA -> TGCGATGCGAT
GTGCGTGACAT -> TGCGTGACATG
GTGCTTCCGAT -> TGCTTCCGATA
GTGGAAAACGA -> TGGAAAACGAA
GTGGAGCATTT -> TGGAGCATTTG
GTGGAGCTCTT -> TGGAGCTCTTA
GTGGGAGTCCG -> TGGGAGTCCGG
GTGGGGGGTCC -> TGGGGGGTCCC
GTGGGTACTTG -> TGGGTACTTGG
GTGGTCAAGGC -> TGGTCAAGGCC
GTGGTGCCGCC -> TGGTGCCGCCG
GTGTCACGCGT -> TGTCACGCGTG
GTGTCCAGTAA -> TGTCCAGTAAG
GTGTCTGTACT -> TGTCTGTACTC
GTGTGCCACGG -> TGTGCCACGGA
GTGTTATCATG -> TGTTATCATGG
GTTAAACCACG -> TTAAACCACGT
GTTAAGGCACC -> TTAAGGCACCA
GTTAAGTACTC -> TTAAGTACTCA
GTTAAGTTGAA -> TTAAGTTGAAC
GTTACCTCGAA -> TTACCTCGAAA
GTTAGCCAAAG -> TTAGCCAAAGG
GTTAGGCCATT -> TTAGGCCATTA
GTTAGTCCTCC -> TTAGTCCTCCG
GTTATCATGGC -> TTATCATGGCA
GTTCAAAGCGG -> TTCAAAGCGGG
GTTCCAATCTT -> TTCCAATCTTC
GTTCCGGCACC -> TTCCGGCACCA
GTTCGAAACCG -> TTCGAAACCGT
GTTCGCACAGC -> TTCGCACAGCT
GTTCGTGCGTG -> TTCGTGCGTGA
GTTCTTAAACC -> TTCTTAAACCT
GTTGAACATTG -> TTGAACATTGC
GTTGAACCGCG -> TTGAACCGCGT
GTTGAGAGCCG -> TTGAGAGCCGG
GTTGAGCAGTT -> TTGAGCAGTTA
GTTGAGCGAGA -> TTGAGCGAGAC
GTTGCGCCATC -> TTGCGCCATCG
GTTGGTCAAGA -> TTGGTCAAGAT
GTTGGTGCCAT -> TTGGTGCCATC
GTTGTGGGGGG -> TTGTGGGGGGT
GTTTCCAGGAC -> TTTCCAGGACC
GTTTCGCCCGT -> TTTCGCCCGTT
GTTTGTGATGA -> TTTGTGATGAC
GTTTTGTTACC -> TTTTGTTACCT
GTTTTTAGGAA -> TTTTTAGGAAC
TAAAATAGGAT -> AAAATAGGATG
TAAACATCCGC -> AAACATCCGCT
TAAACCACGTC -> AAACCACGTCC
TAAACCTATCA -> AAACCTATCAA
TAAATAAATTC -> AAATAAATTCG
TAAATTCGATG -> AAATTCGATGT
TAACAACGGGC -> AACAACGGGCA
TAACAACGTTC -> AACAACGTTCC
TAACAAGTGGA -> AACAAGTGGAG
TAACACGGAGG -> AACACGGAGGC
TAACGCCTTAG -> AACGCCTTAGT
TAACTGAAGAC -> AACTGAAGACA
TAAGAGGATGA -> AAGAGGATGAT
TAAGATGGAGA -> AAGATGGAGAT
TAAGCGGCTTC -> AAGCGGCTTCT
TAAGGCACCAC -> AAGGCACCACC
TAAGTACTCAG -> AAGTACTCAGC
TAAGTGATTGC -> AAGTGATTGCA
TAAGTGTCACG -> AAGTGTCACGC
TAAGTTGAACC -> AAGTTGAACCG
TAATAACGCCT -> AATAACGCCTT
TAATATCGGCA -> AATATCGGCAA
TAATCCGCGGC -> AATCCGCGGCC
TACAACACGGC -> ACAACACGGCT
TACACGCGACA -> ACACGCGACAA
TACAGAATAGA -> ACAGAATAGAT
TACAGTCCCTG -> ACAGTCCCTGA
TACATAGGGCG -> ACATAGGGCGA
TACCACGGCGT -> ACCACGGCGTG
TACCAGTAATC -> ACCAGTAATCC
TACCCAAAGTT -> ACCCAAAGTTC
TACCCAGTACG -> ACCCAGTACGG
TACCGATTAAC -> ACCGATTAACA
TACCGTGCCTG -> ACCGTGCCTGC
TACCTCGAAAG -> ACCTCGAAAGT
TACGAGAGGCA -> ACGAGAGGCAT
TACGAGCAATC -> ACGAGCAATCT
TACGATTGGTT -> ACGATTGGTTG
TACGCCGCCCC -> ACGCCGCCCCC
TACGGAGTCGC -> ACGGAGTCGCG
TACGGCGCACG -> ACGGCGCACGC
TACGGCTTTGA -> ACGGCTTTGAT
TACGTGATCAG -> ACGTGATCAGC
TACGTGGGTAC -> ACGTGGGTACT
TACGTTCGCAC -> ACGTTCGCACA
TACTACCAGTA -> ACTACCAGTAA
TACTACGAGCA -> ACTACGAGCAA
TACTACGTGGG -> ACTACGTGGGT
TACTACTGCAG -> ACTACTGCAGT
TACTAGGAGCC -> ACTAGGAGCCT
TACTATTGATT -> ACTATTGATTA
TACTCAACGTC -> ACTCAACGTCT
TACTCACCATG -> ACTCACCATGG
TACTCAGCATT -> ACTCAGCATTA
TACTGCAGTTT -> ACTGCAGTTTT
TACTTCCCCGT -> ACTTCCCCGTA
TACTTGGATTT -> ACTTGGATTTA
TACTTGTACGG -> ACTTGTACGGA
TACTTTTGATA -> ACTTTTGATAC
TAGACGGCGTA -> AGACGGCGTAC
TAGATCATTAT -> AGATCATTATG
TAGATGCCCGG -> AGATGCCCGGA
TAGCCAAAGGG -> AGCCAAAGGGC
TAGCCCACTGT -> AGCCCACTGTC
TAGCGGTGGTG -> AGCGGTGGTGC
TAGCGTGACCG -> AGCGTGACCGG
TAGCTGCGATC -> AGCTGCGATCG
TAGGAACCGCA -> AGGAACCGCAC
TAGGAACTCCT -> AGGAACTCCTC
TAGGACACTCT -> AGGACACTCTG
TAGGAGCCTCC -> AGGAGCCTCCA
TAGGATGGTAA -> AGGATGGTAAC
TAGGCCATTAT -> AGGCCATTATA
TAGGGAAAATC -> AGGGAAAATCC
TAGGGCATTTC -> AGGGCATTTCA
TAGGGCCATAT -> AGGGCCATATC
TAGGGCGAGCC -> AGGGCGAGCCA
TAGGGGATGAT -> AGGGGATGATT
TAGGTGCCATC -> AGGTGCCATCA
TAGTACTACTG -> AGTACTACTGC
TAGTCCTCCGC -> AGTCCTCCGCG
TAGTCTTAGGG -> AGTCTTAGGGC
TAGTTCCGGCA -> AGTTCCGGCAC
TATAACTGAAG -> ATAACTGAAGA
TATACGAGAGG -> ATACGAGAGGC
TATACTACCAG -> ATACTACCAGT
TATACTTTTGA -> ATACTTTTGAT
TATAGCTGCGA -> ATAGCTGCGAT
TATATAGCTGC -> ATATAGCTGCG
TATATCTCCGT -> ATATCTCCGTA
TATATTACCCA -> ATATTACCCAA
TATCAAGGTTA -> ATCAAGGTTAA
TATCACTGACT -> ATCACTGACTA
TATCATGGCAT -> ATCATGGCATA
TATCCAGGTCA -> ATCCAGGTCAG
TATCCGACGGT -> ATCCGACGGTA
TATCCGGTCCC -> ATCCGGTCCCA
TATCGACCCCG -> ATCGACCCCGG
TATCGGCAAGG -> ATCGGCAAGGG
TATCGGTGTTA -> ATCGGTGTTAT
TATCTCCGTAG -> ATCTCCGTAGA
TATGAGCAGTC -> ATGAGCAGTCT
TATGCGTGCGA -> ATGCGTGCGAG
TATGGCAAAAG -> ATGGCAAAAGC
TATGTCATGCA -> ATGTCATGCAG
TATGTCGTGCT -> ATGTCGTGCTT
TATGTGTCCAG -> ATGTGTCCAGT
TATTACCCAAA -> ATTACCCAAAG
TATTGATTAAG -> ATTGATTAAGA
TATTGGTCCAA -> ATTGGTCCAAC
TATTTCCGGGC -> ATTTCCGGGCT
TATTTTTCTCA -> ATTTTTCTCAT
TCAAAGATTAT -> CAAAGATTATG
TCAAAGCGGGA -> CAAAGCGGGAA
TCAACATAGTT -> CAACATAGTTC
TCAACGTCTGC -> CAACGTCTGCG
TCAACTTGCCG -> CAACTTGCCGC
TCAAGATTTAC -> CAAGATTTACG
TCAAGGCCCAA -> CAAGGCCCAAA
TCAAGGTTAAG -> CAAGGTTAAGT
TCAAGTATTTT -> CAAGTATTTTT
TCAAGTGGTCA -> CAAGTGGTCAA
TCACCAAGGGT -> CACCAAGGGTC
TCACCATGGGT -> CACCATGGGTT
TCACCGTGCAA -> CACCGTGCAAA
TCACGCGTGAG -> CACGCGTGAGA
TCACTGACTAT -> CACTGACTATA
TCAGAGGGACA -> CAGAGGGACAT
TCAGCAAGGCT -> CAGCAAGGCTC
TCAGCATTATA -> CAGCATTATAT
TCAGCGTATAC -> CAGCGTATACG
TCAGGCCGGGT -> CAGGCCGGGTC
TCAGGTTAGTC -> CAGGTTAGTCC
TCATAGGGAAA -> CATAGGGAAAA
TCATATGAGCA -> CATATGAGCAG
TCATGCAGCCT -> CATGCAGCCTT
TCATGGCATAT -> CATGGCATATT
TCATTATGGCA -> CATTATGGCAA
TCATTTAGGAC -> CATTTAGGACA
TCATTTGTGCA -> CATTTGTGCAG
TCCAACGACCT -> CCAACGACCTG
TCCAATACCCA -> CCAATACCCAG
TCCAATCTTCA -> CCAATCTTCAA
TCCACGCGAAC -> CCACGCGAACG
TCCACGGCAGG -> CCACGGCAGGG
TCCACTACTAC -> CCACTACTACG
TCCAGGACCCC -> CCAGGACCCCC
TCCAGGTCAGA -> CCAGGTCAGAG
TCCAGTAAGAG -> CCAGTAAGAGG
TCCAGTTAAGG -> CCAGTTAAGGC
TCCCAATAATA -> CCCAATAATAT
TCCCAGTAACA -> CCCAGTAACAA
TCCCATGTCGT -> CCCATGTCGTT
TCCCCGCTTCT -> CCCCGCTTCTG
TCCCCGTACCA -> CCCCGTACCAC
TCCCGCGGGGC -> CCCGCGGGGCA
TCCCTCCACGC -> CCCTCCACGCG
TCCCTGATTGT -> CCCTGATTGTC
TCCCTTTGAAT -> CCCTTTGAATA
TCCGACGGTAC -> CCGACGGTACT
TCCGATATCCA -> CCGATATCCAG
TCCGATCGCAA -> CCGATCGCAAC
TCCGCCACTAC -> CCGCCACTACA
TCCGCGGATCG -> CCGCGGATCGC
TCCGCGGCCCA -> CCGCGGCCCAC
TCCGCTGCCTT -> CCGCTGCCTTA
TCCGGCACCAA -> CCGGCACCAAA
TCCGGCATAAG -> CCGGCATAAGT
TCCGGCGCTTT -> CCGGCGCTTTA
TCCGGGCGTGC -> CCGGGCGTGCG
TCCGGGCTTAC -> CCGGGCTTACT
TCCGGTCCCAT -> CCGGTCCCATG
TCCGTAGACGG -> CCGTAGACGGC
TCCTATCCGGT -> CCTATCCGGTC
TCCTCCCAGTA -> CCTCCCAGTAA
TCCTCCGCGGA -> CCTCCGCGGAT
TCCTGCGAGGA -> CCTGCGAGGAT
TCGAAACCGTG -> CGAAACCGTGG
TCGAAAGGCTT -> CGAAAGGCTTA
TCGAAAGTTGT -> CGAAAGTTGTG
TCGAACCCCTT -> CGAACCCCTTT
TCGAACCTGGA -> CGAACCTGGAG
TCGAATGTGGG -> CGAATGTGGGA
TCGACCCCGGA -> CGACCCCGGAT
TCGATAGCGTG -> CGATAGCGTGA
TCGATATTGGT -> CGATATTGGTC
TCGATGTGCGA -> CGATGTGCGAG
TCGCAACCGAC -> CGCAACCGACT
TCGCAACGTGA -> CGCAACGTGAT
TCGCACAGCTT -> CGCACAGCTTT
TCGCAGCCGAG -> CGCAGCCGAGT
TCGCCCGTTTT -> CGCCCGTTTTT
TCGCGATCAAG -> CGCGATCAAGT
TCGCGGCAAAG -> CGCGGCAAAGC
TCGGCAAGGGT -> CGGCAAGGGTT
TCGGCATTCGA -> CGGCATTCGAA
TCGGCCCAGTT -> CGGCCCAGTTG
TCGGTGGAGCA -> CGGTGGAGCAT
TCGGTGTTATC -> CGGTGTTATCA
TCGGTTCGTGC -> CGGTTCGTGCG
TCGTCCCAATA -> CGTCCCAATAA
TCGTCGGCATT -> CGTCGGCATTC
TCGTGCGTGAC -> CGTGCGTGACA
TCGTGCTTCCG -> CGTGCTTCCGA
TCGTTAAACCA -> CGTTAAACCAC
TCGTTGAGAGC -> CGTTGAGAGCC
TCTACGCCGCC -> CTACGCCGCCC
TCTACTCACCA -> CTACTCACCAT
TCTAGGTGCCA -> CTAGGTGCCAT
TCTCATATGAG -> CTCATATGAGC
TCTCCGTAGAC -> CTCCGTAGACG
TCTCCTGCGAG -> CTCCTGCGAGG
TCTCGAACCTG -> CTCGAACCTGG
TCTGAACCATT -> CTGAACCATTA
TCTGATGAACT -> CTGATGAACTG
TCTGCATCTTA -> CTGCATCTTAG
TCTGCCATACA -> CTGCCATACAA
TCTGCGGCGCA -> CTGCGGCGCAC
TCTGTACTCAA -> CTGTACTCAAC
TCTGTAGATCA -> CTGTAGATCAT
TCTTAAACCTA -> CTTAAACCTAT
TCTTAGCGGTG -> CTTAGCGGTGG
TCTTAGGAACC -> CTTAGGAACCG
TCTTAGGGCCA -> CTTAGGGCCAT
TCTTATCCGAC -> CTTATCCGACG
TCTTCAACTTG -> CTTCAACTTGC
TCTTCCGGCAT -> CTTCCGGCATA
TCTTTCGCAAC -> CTTTCGCAACG
TGAACATTGCA -> GAACATTGCAA
TGAACCATTAC -> GAACCATTACC
TGAACCGCGTA -> GAACCGCGTAA
TGAACTGACCA -> GAACTGACCAG
TGAAGACAGCC -> GAAGACAGCCA
TGAATAGCCCA -> GAATAGCCCAC
TGACAACAATC -> GACAACAATCC
TGACATGTTTG -> GACATGTTTGT
TGACCAGACAC -> GACCAGACACT
TGACCGGATAA -> GACCGGATAAT
TGACTATACTT -> GACTATACTTT
TGAGAAGGTTG -> GAGAAGGTTGA
TGAGAGCCGGC -> GAGAGCCGGCC
TGAGCAGTCTT -> GAGCAGTCTTC
TGAGCAGTTAG -> GAGCAGTTAGG
TGAGCGAGACG -> GAGCGAGACGC
TGAGCGCGCGA -> GAGCGCGCGAA
TGAGCTTAAAA -> GAGCTTAAAAT
TGATAACAAGT -> GATAACAAGTG
TGATACGGCGC -> GATACGGCGCA
TGATAGGGGAT -> GATAGGGGATG
TGATCAGCAAG -> GATCAGCAAGG
TGATCGATAGC -> GATCGATAGCG
TGATCGCGATC -> GATCGCGATCA
TGATGAACTGA -> GATGAACTGAC
TGATGACAACA -> GATGACAACAA
TGATTAAGATG -> GATTAAGATGG
TGATTATGTCG -> GATTATGTCGT
TGATTGCAGAC -> GATTGCAGACG
TGATTGCTGCG -> GATTGCTGCGA
TGATTGTCAGC -> GATTGTCAGCG
TGATTTCACCG -> GATTTCACCGT
TGCAAACTCCG -> GCAAACTCCGC
TGCAACTCGGC -> GCAACTCGGCC
TGCAGACGTCC -> GCAGACGTCCG
TGCAGCAAAAG -> GCAGCAAAAGC
TGCAGCCTTGA -> GCAGCCTTGAT
TGCAGTTCTTA -> GCAGTTCTTAA
TGCAGTTGAAC -> GCAGTTGAACA
TGCAGTTTTGT -> GCAGTTTTGTT
TGCATCTTAGG -> GCATCTTAGGA
TGCATTCTAGG -> GCATTCTAGGT
TGCCACGGAGA -> GCCACGGAGAG
TGCCATACAAC -> GCCATACAACA
TGCCATCACCA -> GCCATCACCAA
TGCCATCGTCC -> GCCATCGTCCC
TGCCCGGACAA -> GCCCGGACAAT
TGCCGAGGTCT -> GCCGAGGTCTA
TGCCGCCGCGC -> GCCGCCGCGCG
TGCCGCTGAGC -> GCCGCTGAGCG
TGCCGGTGCCT -> GCCGGTGCCTT
TGCCGTCGTTG -> GCCGTCGTTGA
TGCCTGCCGGT -> GCCTGCCGGTG
TGCCTTATCGG -> GCCTTATCGGT
TGCCTTTGCTG -> GCCTTTGCTGC
TGCGACCTTGT -> GCGACCTTGTG
TGCGAGATAGG -> GCGAGATAGGG
TGCGAGATCTA -> GCGAGATCTAC
TGCGAGGATTC -> GCGAGGATTCA
TGCGATCGTCG -> GCGATCGTCGG
TGCGATGATTT -> GCGATGATTTC
TGCGATGCGAT -> GCGATGCGATG
TGCGCCATCGA -> GCGCCATCGAT
TGCGGCGCACC -> GCGGCGCACCC
TGCGTGACATG -> GCGTGACATGT
TGCGTGCGAGA -> GCGTGCGAGAT
TGCGTTGGTCA -> GCGTTGGTCAA
TGCTCGAATGT -> GCTCGAATGTG
TGCTGCATTCT -> GCTGCATTCTA
TGCTGCGACCT -> GCTGCGACCTT
TGCTTCCGATA -> GCTTCCGATAT
TGGAAAACGAA -> GGAAAACGAAT
TGGAATCTGCC -> GGAATCTGCCA
TGGAGATTCTG -> GGAGATTCTGA
TGGAGCATTTG -> GGAGCATTTGT
TGGAGCTCTTA -> GGAGCTCTTAT
TGGAGTTCAAA -> GGAGTTCAAAG
TGGATTTATAT -> GGATTTATATC
TGGCAAAAGCT -> GGCAAAAGCTA
TGGCATATTTC -> GGCATATTTCC
TGGCCAGGTGC -> GGCCAGGTGCA
TGGGAGTCCGG -> GGGAGTCCGGG
TGGGGGGTCCC -> GGGGGGTCCCT
TGGGTACTTGG -> GGGTACTTGGA
TGGGTTAGCCA -> GGGTTAGCCAA
TGGTCAACATA -> GGTCAACATAG
TGGTCAAGATT -> GGTCAAGATTT
TGGTCAAGGCC -> GGTCAAGGCCC
TGGTCCAACGA -> GGTCCAACGAC
TGGTGCCATCG -> GGTGCCATCGT
TGGTGCCGCCG -> GGTGCCGCCGC
TGGTTGCGCCA -> GGTTGCGCCAT
TGTACGGAGTC -> GTACGGAGTCG
TGTACTCAACG -> GTACTCAACGT
TGTACTTCCCC -> GTACTTCCCCG
TGTAGATCATT -> GTAGATCATTA
TGTCACGCGTG -> GTCACGCGTGA
TGTCAGCGTAT -> GTCAGCGTATA
TGTCATGCAGC -> GTCATGCAGCC
TGTCCAGTAAG -> GTCCAGTAAGA
TGTCCTATCCG -> GTCCTATCCGG
TGTCGTGCTTC -> GTCGTGCTTCC
TGTCGTTAAAC -> GTCGTTAAACC
TGTCTGTACTC -> GTCTGTACTCA
TGTGATGACAA -> GTGATGACAAC
TGTGCAGCAAA -> GTGCAGCAAAA
TGTGCAGTTGA -> GTGCAGTTGAA
TGTGCCACGGA -> GTGCCACGGAG
TGTGCCGTCGT -> GTGCCGTCGTT
TGTGCGAGATC -> GTGCGAGATCT
TGTGGGAGTCC -> GTGGGAGTCCG
TGTGGGGGGTC -> GTGGGGGGTCC
TGTGTCCAGTA -> GTGTCCAGTAA
TGTTACCTCGA -> GTTACCTCGAA
TGTTATCATGG -> GTTATCATGGC
TGTTGAGCGAG -> GTTGAGCGAGA
TGTTTCGCCCG -> GTTTCGCCCGT
TGTTTGTGATG -> GTTTGTGATGA
TTAAAATAGGA -> TAAAATAGGAT
TTAAACATCCG -> TAAACATCCGC
TTAAACCACGT -> TAAACCACGTC
TTAAACCTATC -> TAAACCTATCA
TTAAATAAATT -> TAAATAAATTC
TTAACACGGAG -> TAACACGGAGG
TTAAGATGGAG -> TAAGATGGAGA
TTAAGGCACCA -> TAAGGCACCAC
TTAAGTACTCA -> TAAGTACTCAG
TTAAGTTGAAC -> TAAGTTGAACC
TTACCCAAAGT -> TACCCAAAGTT
TTACCGATTAA -> TACCGATTAAC
TTACCGTGCCT -> TACCGTGCCTG
TTACCTCGAAA -> TACCTCGAAAG
TTACGTTCGCA -> TACGTTCGCAC
TTACTAGGAGC -> TACTAGGAGCC
TTACTATTGAT -> TACTATTGATT
TTACTTGTACG -> TACTTGTACGG
TTAGCCAAAGG -> TAGCCAAAGGG
TTAGCGGTGGT -> TAGCGGTGGTG
TTAGGAACCGC -> TAGGAACCGCA
TTAGGAACTCC -> TAGGAACTCCT
TTAGGACACTC -> TAGGACACTCT
TTAGGCCATTA -> TAGGCCATTAT
TTAGGGCCATA -> TAGGGCCATAT
TTAGTCCTCCG -> TAGTCCTCCGC
TTAGTCTTAGG -> TAGTCTTAGGG
TTATAACTGAA -> TATAACTGAAG
TTATATAGCTG -> TATATAGCTGC
TTATATCTCCG -> TATATCTCCGT
TTATCACTGAC -> TATCACTGACT
TTATCATGGCA -> TATCATGGCAT
TTATCCGACGG -> TATCCGACGGT
TTATCGGTGTT -> TATCGGTGTTA
TTATGCGTGCG -> TATGCGTGCGA
TTATGGCAAAA -> TATGGCAAAAG
TTATGTCATGC -> TATGTCATGCA
TTATGTCGTGC -> TATGTCGTGCT
TTCAAAGCGGG -> TCAAAGCGGGA
TTCAACTTGCC -> TCAACTTGCCG
TTCACCGTGCA -> TCACCGTGCAA
TTCAGGTTAGT -> TCAGGTTAGTC
TTCATTTAGGA -> TCATTTAGGAC
TTCATTTGTGC -> TCATTTGTGCA
TTCCAATCTTC -> TCCAATCTTCA
TTCCAGGACCC -> TCCAGGACCCC
TTCCAGTTAAG -> TCCAGTTAAGG
TTCCCCGTACC -> TCCCCGTACCA
TTCCGATATCC -> TCCGATATCCA
TTCCGGCACCA -> TCCGGCACCAA
TTCCGGCATAA -> TCCGGCATAAG
TTCCGGCGCTT -> TCCGGCGCTTT
TTCCGGGCTTA -> TCCGGGCTTAC
TTCGAAACCGT -> TCGAAACCGTG
TTCGAACCCCT -> TCGAACCCCTT
TTCGATGTGCG -> TCGATGTGCGA
TTCGCAACGTG -> TCGCAACGTGA
TTCGCACAGCT -> TCGCACAGCTT
TTCGCCCGTTT -> TCGCCCGTTTT
TTCGTGCGTGA -> TCGTGCGTGAC
TTCTAGGTGCC -> TCTAGGTGCCA
TTCTCATATGA -> TCTCATATGAG
TTCTCGAACCT -> TCTCGAACCTG
TTCTGATGAAC -> TCTGATGAACT
TTCTGCATCTT -> TCTGCATCTTA
TTCTGTAGATC -> TCTGTAGATCA
TTCTTAAACCT -> TCTTAAACCTA
TTGAACATTGC -> TGAACATTGCA
TTGAACCGCGT -> TGAACCGCGTA
TTGAATAGCCC -> TGAATAGCCCA
TTGAGAGCCGG -> TGAGAGCCGGC
TTGAGCAGTTA -> TGAGCAGTTAG
TTGAGCGAGAC -> TGAGCGAGACG
TTGATACGGCG -> TGATACGGCGC
TTGATAGGGGA -> TGATAGGGGAT
TTGATCGCGAT -> TGATCGCGATC
TTGATTAAGAT -> TGATTAAGATG
TTGCAACTCGG -> TGCAACTCGGC
TTGCAGACGTC -> TGCAGACGTCC
TTGCCGCTGAG -> TGCCGCTGAGC
TTGCGCCATCG -> TGCGCCATCGA
TTGCTGCATTC -> TGCTGCATTCT
TTGCTGCGACC -> TGCTGCGACCT
TTGGATTTATA -> TGGATTTATAT
TTGGCCAGGTG -> TGGCCAGGTGC
TTGGTCAAGAT -> TGGTCAAGATT
TTGGTCCAACG -> TGGTCCAACGA
TTGGTGCCATC -> TGGTGCCATCG
TTGGTTGCGCC -> TGGTTGCGCCA
TTGTACGGAGT -> TGTACGGAGTC
TTGTACTTCCC -> TGTACTTCCCC
TTGTCAGCGTA -> TGTCAGCGTAT
TTGTGATGACA -> TGTGATGACAA
TTGTGCAGCAA -> TGTGCAGCAAA
TTGTGCAGTTG -> TGTGCAGTTGA
TTGTGCCGTCG -> TGTGCCGTCGT
TTGTGGGGGGT -> TGTGGGGGGTC
TTGTTACCTCG -> TGTTACCTCGA
TTTAAATAAAT -> TTAAATAAATT
TTTACCGTGCC -> TTACCGTGCCT
TTTACGTTCGC -> TTACGTTCGCA
TTTAGGAACTC -> TTAGGAACTCC
TTTAGGACACT -> TTAGGACACTC
TTTATATCTCC -> TTATATCTCCG
TTTATGCGTGC -> TTATGCGTGCG
TTTCACCGTGC -> TTCACCGTGCA
TTTCAGGTTAG -> TTCAGGTTAGT
TTTCATTTGTG -> TTCATTTGTGC
TTTCCAGGACC -> TTCCAGGACCC
TTTCCGGGCTT -> TTCCGGGCTTA
TTTCGCAACGT -> TTCGCAACGTG
TTTCGCCCGTT -> TTCGCCCGTTT
TTTCTCATATG -> TTCTCATATGA
TTTCTGCATCT -> TTCTGCATCTT
TTTGAATAGCC -> TTGAATAGCCC
TTTGATACGGC -> TTGATACGGCG
TTTGATCGCGA -> TTGATCGCGAT
TTTGCTGCATT -> TTGCTGCATTC
TTTGGCCAGGT -> TTGGCCAGGTG
TTTGTGATGAC -> TTGTGATGACA
TTTGTGCAGCA -> TTGTGCAGCAA
TTTGTGCAGTT -> TTGTGCAGTTG
TTTGTTACCTC -> TTGTTACCTCG
TTTTAGGAACT -> TTTAGGAACTC
TTTTCTCATAT -> TTTCTCATATG
TTTTGATACGG -> TTTGATACGGC
TTTTGGCCAGG -> TTTGGCCAGGT
TTTTGTTACCT -> TTTGTTACCTC
TTTTTAGGAAC -> TTTTAGGAACT
TTTTTCTCATA -> TTTTCTCATAT
TTTTTGGCCAG -> TTTTGGCCAGG
TTTTTTGGCCA -> TTTTTGGCCAG
