AAAAAACATAC -> AAAAACATACA
AAAAAAGATAT -> AAAAAGATATG
AAAAACATACA -> AAAACATACAT
AAAAAGATATG -> AAAAGATATGC
AAAAATTAGCG -> AAAATTAGCGA
AAAACATACAT -> AAACATACATA
AAAACCATAAC -> AAACCATAACT
AAAACGTTCGA -> AAACGTTCGAG
AAAAGATATGC -> AAAGATATGCC
AAAAGGGACAT -> AAAGGGACATA
AAAATCGATGT -> AAATCGATGTT
AAAATTAGAAG -> AAATTAGAAGC
AAAATTAGCGA -> AAATTAGCGAA
AAACAGCCATA -> AACAGCCATAG
AAACATACATA -> AACATACATAT
AAACATTGGTA -> AACATTGGTAT
AAACCATAACT -> AACCATAACTA
AAACGACGATT -> AACGACGATTG
AAACGGGTACA -> AACGGGTACAA
AAACGTTCGAG -> AACGTTCGAGG
AAACTCTCATG -> AACTCTCATGA
AAACTGGTGGT -> AACTGGTGGTA
AAACTTGACTG -> AACTTGACTGA
AAAGACAGAGA -> AAGACAGAGAC
AAAGATATGCC -> AAGATATGCCC
AAAGCCACGAT -> AAGCCACGATC
AAAGGGACATA -> AAGGGACATAA
AAAGTACATTC -> AAGTACATTCT
AAATACCCCAA -> AATACCCCAAC
AAATACCGGAA -> AATACCGGAAA
AAATAGGGGCC -> AATAGGGGCCG
AAATCGAGCTC -> AATCGAGCTCG
AAATCGATGTT -> AATCGATGTTA
AAATGTTTACG -> AATGTTTACGC
AAATTAGAAGC -> AATTAGAAGCA
AAATTAGCGAA -> AATTAGCGAAG
AAATTGAGCAT -> AATTGAGCATT
AACAATCTCTG -> ACAATCTCTGT
AACAGAAGGTC -> ACAGAAGGTCC
AACAGAATAGT -> ACAGAATAGTC
AACAGCCATAG -> ACAGCCATAGG
AACAGCGTGAT -> ACAGCGTGATT
AACATACATAT -> ACATACATATA
AACATTGGTAT -> ACATTGGTATG
AACCAGTTTTA -> ACCAGTTTTAT
AACCATAACTA -> ACCATAACTAT
AACCGAATATG -> ACCGAATATGG
AACCGGTCCTT -> ACCGGTCCTTT
AACGACGATTG -> ACGACGATTGG
AACGGGTACAA -> ACGGGTACAAA
AACGGGTTGCA -> ACGGGTTGCAA
AACGTCCCAGG -> ACGTCCCAGGG
AACGTCTGGTC -> ACGTCTGGTCC
AACGTTCGAGG -> ACGTTCGAGGT
AACTAGCAAAG -> ACTAGCAAAGT
AACTATGGTTT -> ACTATGGTTTC
AACTCAAAGAC -> ACTCAAAGACA
AACTCGATAAG -> ACTCGATAAGA
AACTCTCATGA -> ACTCTCATGAT
AACTGGTGGTA -> ACTGGTGGTAA
AACTTACTGGC -> ACTTACTGGCT
AACTTAGCTTT -> ACTTAGCTTTC
AACTTCTATGG -> ACTTCTATGGC
AACTTGACTGA -> ACTTGACTGAA
AACTTTTATCA -> ACTTTTATCAA
AAGAAGAAGCA -> AGAAGAAGCAA
AAGAAGCAAAT -> AGAAGCAAATA
AAGACAGAGAC -> AGACAGAGACA
AAGACCGACGC -> AGACCGACGCA
AAGACTCTCCG -> AGACTCTCCGT
AAGAGCAGCCC -> AGAGCAGCCCT
AAGAGTCTAAT -> AGAGTCTAATC
AAGATAATGTT -> AGATAATGTTT
AAGATATGCCC -> AGATATGCCCG
AAGATTGAAGT -> AGATTGAAGTA
AAGCAAATACC -> AGCAAATACCC
AAGCAATTCTC -> AGCAATTCTCG
AAGCACGGTCC -> AGCACGGTCCC
AAGCATAGAGC -> AGCATAGAGCG
AAGCCACGATC -> AGCCACGATCC
AAGCCGATGGT -> AGCCGATGGTT
AAGCCGTGAAA -> AGCCGTGAAAC
AAGCGGCCAGT -> AGCGGCCAGTA
AAGCGGTTTGC -> AGCGGTTTGCG
AAGCTATGCTT -> AGCTATGCTTC
AAGCTGGGGTT -> AGCTGGGGTTA
AAGCTGGTACA -> AGCTGGTACAT
AAGGAAGTACC -> AGGAAGTACCT
AAGGGACATAA -> AGGGACATAAG
AAGGGGAAACA -> AGGGGAAACAG
AAGGGTCACCT -> AGGGTCACCTC
AAGGTCAAAAA -> AGGTCAAAAAA
AAGGTCCACGG -> AGGTCCACGGT
AAGGTCTGGAC -> AGGTCTGGACT
AAGTACATTCT -> AGTACATTCTT
AAGTACCTCGA -> AGTACCTCGAG
AAGTAGGCCTT -> AGTAGGCCTTG
AAGTCCCGTTG -> AGTCCCGTTGT
AAGTCTGGCAT -> AGTCTGGCATA
AAGTGGTCCGA -> AGTGGTCCGAA
AAGTGTTCGTA -> AGTGTTCGTAT
AAGTTCCGCCT -> AGTTCCGCCTA
AAGTTTTATGT -> AGTTTTATGTC
AATAACTTAGC -> ATAACTTAGCT
AATAAGATAAT -> ATAAGATAATG
AATAAGCGGCC -> ATAAGCGGCCA
AATACCAGAAA -> ATACCAGAAAA
AATACCCCAAC -> ATACCCCAACG
AATACCGGAAA -> ATACCGGAAAA
AATACGCGAAA -> ATACGCGAAAT
AATACTGTACA -> ATACTGTACAC
AATAGGGGCCG -> ATAGGGGCCGC
AATAGTCCCAC -> ATAGTCCCACC
AATATGGTATG -> ATATGGTATGG
AATATTCATTA -> ATATTCATTAA
AATCAAACTTG -> ATCAAACTTGA
AATCAATAAGA -> ATCAATAAGAT
AATCAATCAAA -> ATCAATCAAAC
AATCCCCAACT -> ATCCCCAACTT
AATCGAGCTCG -> ATCGAGCTCGA
AATCGATGTTA -> ATCGATGTTAA
AATCGGGGGTG -> ATCGGGGGTGC
AATCGTGTTCT -> ATCGTGTTCTC
AATCTAATACC -> ATCTAATACCA
AATCTCTGTTC -> ATCTCTGTTCC
AATCTTGGATC -> ATCTTGGATCG
AATGAGAGTGC -> ATGAGAGTGCA
AATGGCGGGAG -> ATGGCGGGAGG
AATGTTTACGC -> ATGTTTACGCT
AATGTTTGGAA -> ATGTTTGGAAA
AATTAGAAGCA -> ATTAGAAGCAC
AATTAGCGAAG -> ATTAGCGAAGC
AATTCGGTGGT -> ATTCGGTGGTA
AATTCGTTCGT -> ATTCGTTCGTG
AATTCTCGTTT -> ATTCTCGTTTG
AATTGAGCATT -> ATTGAGCATTC
AATTGCCATTC -> ATTGCCATTCT
AATTTGGGAAT -> ATTTGGGAATC
ACAAAGCCACG -> CAAAGCCACGA
ACAACCGAATA -> CAACCGAATAT
ACAAGACTCTC -> CAAGACTCTCC
ACAAGAGTCTA -> CAAGAGTCTAA
ACAATCTCTGT -> CAATCTCTGTT
ACACAACCGAA -> CACAACCGAAT
ACACGCCTCAC -> CACGCCTCACG
ACACTGATGAT -> CACTGATGATC
ACACTGGGTCT -> CACTGGGTCTA
ACACTTCACAG -> CACTTCACAGG
ACAGAAGGTCC -> CAGAAGGTCCA
ACAGAATACTG -> CAGAATACTGT
ACAGAATAGTC -> CAGAATAGTCC
ACAGAGACATG -> CAGAGACATGT
ACAGCCATAGG -> CAGCCATAGGA
ACAGCGTGATT -> CAGCGTGATTG
ACAGGACGACC -> CAGGACGACCT
ACAGGATATGT -> CAGGATATGTT
ACAGTTGTCAG -> CAGTTGTCAGA
ACATAACAATC -> CATAACAATCT
ACATAAGCATA -> CATAAGCATAG
ACATACATATA -> CATACATATAA
ACATATAAGCA -> CATATAAGCAC
ACATATAGACT -> CATATAGACTA
ACATCACTATC -> CATCACTATCT
ACATGAGCATG -> CATGAGCATGT
ACATGTCAACA -> CATGTCAACAG
ACATGTCTAAG -> CATGTCTAAGG
ACATTCCGATG -> CATTCCGATGG
ACATTCTTCGG -> CATTCTTCGGT
ACATTGGTATG -> CATTGGTATGC
ACCAAGATTGA -> CCAAGATTGAA
ACCAGAAAAAA -> CCAGAAAAAAG
ACCAGTCAAAC -> CCAGTCAAACG
ACCAGTTTTAT -> CCAGTTTTATG
ACCATAACTAT -> CCATAACTATG
ACCATCTACAC -> CCATCTACACT
ACCATGCGTGT -> CCATGCGTGTG
ACCCCAACGTC -> CCCCAACGTCT
ACCCCAGGTCA -> CCCCAGGTCAA
ACCCCGGGTAG -> CCCCGGGTAGG
ACCCTAGGTGG -> CCCTAGGTGGA
ACCGAATATGG -> CCGAATATGGT
ACCGACGCATT -> CCGACGCATTA
ACCGATTATTA -> CCGATTATTAT
ACCGCCCATTT -> CCGCCCATTTC
ACCGCGGCGGC -> CCGCGGCGGCT
ACCGGAAAAAT -> CCGGAAAAATT
ACCGGGGAACT -> CCGGGGAACTT
ACCGGTCCTTT -> CCGGTCCTTTT
ACCGTAAATAC -> CCGTAAATACC
ACCTATGAAAC -> CCTATGAAACG
ACCTCAGAAGT -> CCTCAGAAGTT
ACCTCCTTTCC -> CCTCCTTTCCG
ACCTCGAGACT -> CCTCGAGACTG
ACCTCGCTGGC -> CCTCGCTGGCG
ACCTGAATATT -> CCTGAATATTC
ACCTTGTGGTC -> CCTTGTGGTCC
ACGACCTCGCT -> CGACCTCGCTG
ACGACGATTGG -> CGACGATTGGC
ACGATCCAAAT -> CGATCCAAATC
ACGATCTGATG -> CGATCTGATGA
ACGATTGGCGC -> CGATTGGCGCA
ACGCATGTGAT -> CGCATGTGATC
ACGCATTATCA -> CGCATTATCAC
ACGCCTCACGT -> CGCCTCACGTA
ACGCCTCCACA -> CGCCTCCACAT
ACGCGAAATTG -> CGCGAAATTGA
ACGCTACGGTT -> CGCTACGGTTC
ACGCTATAGTC -> CGCTATAGTCA
ACGCTTGCAGT -> CGCTTGCAGTA
ACGGCAGGATG -> CGGCAGGATGG
ACGGGTACAAA -> CGGGTACAAAG
ACGGGTTGCAA -> CGGGTTGCAAT
ACGGTCCCAGA -> CGGTCCCAGAA
ACGGTGAAGCC -> CGGTGAAGCCG
ACGGTTCGAGA -> CGGTTCGAGAC
ACGGTTCGGGA -> CGGTTCGGGAT
ACGTAAAATCG -> CGTAAAATCGA
ACGTAGCATGC -> CGTAGCATGCC
ACGTCCAGGCC -> CGTCCAGGCCC
ACGTCCCAGGG -> CGTCCCAGGGT
ACGTCTGGTCC -> CGTCTGGTCCC
ACGTCTTGCTT -> CGTCTTGCTTT
ACGTGTCTGTG -> CGTGTCTGTGA
ACGTTCGAGGT -> CGTTCGAGGTT
ACTAGCAAAGT -> CTAGCAAAGTA
ACTATCTCCTT -> CTATCTCCTTG
ACTATGCCTCT -> CTATGCCTCTA
ACTATGGTTTC -> CTATGGTTTCC
ACTCAAAGACA -> CTCAAAGACAG
ACTCAATGAGA -> CTCAATGAGAG
ACTCGATAAGA -> CTCGATAAGAA
ACTCTCATGAT -> CTCTCATGATA
ACTCTCCGTCA -> CTCTCCGTCAC
ACTGAAGCGGT -> CTGAAGCGGTT
ACTGATCGCAG -> CTGATCGCAGT
ACTGATGATCA -> CTGATGATCAT
ACTGCCAACGT -> CTGCCAACGTC
ACTGGCTTCGG -> CTGGCTTCGGG
ACTGGGTCTAA -> CTGGGTCTAAT
ACTGGTGGTAA -> CTGGTGGTAAA
ACTGTACACAA -> CTGTACACAAC
ACTGTTCGTGG -> CTGTTCGTGGA
ACTTACTGGCT -> CTTACTGGCTT
ACTTAGCTTTC -> CTTAGCTTTCG
ACTTCACAGGA -> CTTCACAGGAC
ACTTCTATGGC -> CTTCTATGGCC
ACTTGACTGAA -> CTTGACTGAAG
ACTTTTATCAA -> CTTTTATCAAT
AGAAAAAAGAT -> GAAAAAAGATA
AGAACGGGTTG -> GAACGGGTTGC
AGAAGAAGCAA -> GAAGAAGCAAA
AGAAGCAAATA -> GAAGCAAATAC
AGAAGCACGGT -> GAAGCACGGTC
AGAAGGTCCAC -> GAAGGTCCACG
AGAAGTTCCGC -> GAAGTTCCGCC
AGAATACTGTA -> GAATACTGTAC
AGAATAGTCCC -> GAATAGTCCCA
AGAATCGGGGG -> GAATCGGGGGT
AGAATGGCGGG -> GAATGGCGGGA
AGACACTGGGT -> GACACTGGGTC
AGACAGAGACA -> GACAGAGACAT
AGACATGTCAA -> GACATGTCAAC
AGACCGACGCA -> GACCGACGCAT
AGACTATGCCT -> GACTATGCCTC
AGACTCAATGA -> GACTCAATGAG
AGACTCTCCGT -> GACTCTCCGTC
AGACTGTTCGT -> GACTGTTCGTG
AGAGACATGTC -> GAGACATGTCA
AGAGCAGCCCT -> GAGCAGCCCTA
AGAGCGCGGGT -> GAGCGCGGGTC
AGAGGAGGATG -> GAGGAGGATGA
AGAGTCTAATC -> GAGTCTAATCC
AGAGTGCATAT -> GAGTGCATATC
AGATAATGTTT -> GATAATGTTTG
AGATACGTCCA -> GATACGTCCAG
AGATATGCCCG -> GATATGCCCGC
AGATGTCAGCA -> GATGTCAGCAT
AGATTGAAGTA -> GATTGAAGTAG
AGCAAAGTACA -> GCAAAGTACAT
AGCAAATACCC -> GCAAATACCCC
AGCAATTCTCG -> GCAATTCTCGT
AGCACCGTAAA -> GCACCGTAAAT
AGCACGGTCCC -> GCACGGTCCCA
AGCAGCCCTAC -> GCAGCCCTACA
AGCATAGAGCG -> GCATAGAGCGC
AGCATGATTCA -> GCATGATTCAG
AGCATGCCCAC -> GCATGCCCACC
AGCATGTCGTC -> GCATGTCGTCA
AGCATTCACGT -> GCATTCACGTC
AGCCACGATCC -> GCCACGATCCA
AGCCATAGGAG -> GCCATAGGAGG
AGCCATTATCT -> GCCATTATCTG
AGCCCCGTTTA -> GCCCCGTTTAT
AGCCCTACAGG -> GCCCTACAGGA
AGCCGATGGTT -> GCCGATGGTTG
AGCCGTGAAAC -> GCCGTGAAACT
AGCCGTTGTCT -> GCCGTTGTCTG
AGCGAAGCCGA -> GCGAAGCCGAT
AGCGCGGGTCG -> GCGCGGGTCGT
AGCGGCCAGTA -> GCGGCCAGTAC
AGCGGGCTGCC -> GCGGGCTGCCA
AGCGGTTTGCG -> GCGGTTTGCGT
AGCGTGATTGT -> GCGTGATTGTC
AGCTATGCTTC -> GCTATGCTTCG
AGCTCGACCGC -> GCTCGACCGCC
AGCTGGCCAAC -> GCTGGCCAACA
AGCTGGGGTTA -> GCTGGGGTTAG
AGCTGGTACAT -> GCTGGTACATT
AGCTTTCGGAT -> GCTTTCGGATC
AGGAACAGCGT -> GGAACAGCGTG
AGGAAGTACCT -> GGAAGTACCTC
AGGAATTGCCA -> GGAATTGCCAT
AGGACGACCTC -> GGACGACCTCG
AGGACGCTATA -> GGACGCTATAG
AGGAGGATGAC -> GGAGGATGACC
AGGAGGCCGAA -> GGAGGCCGAAG
AGGATATGTTA -> GGATATGTTAA
AGGATGACCAT -> GGATGACCATG
AGGATGGTGTG -> GGATGGTGTGC
AGGCCCCCATA -> GGCCCCCATAC
AGGCCGAAGCA -> GGCCGAAGCAA
AGGCCTTGGAG -> GGCCTTGGAGA
AGGGAAACATT -> GGGAAACATTG
AGGGACATAAG -> GGGACATAAGC
AGGGAGTGTCC -> GGGAGTGTCCT
AGGGCTTACAT -> GGGCTTACATG
AGGGGAAACAG -> GGGGAAACAGC
AGGGGCCGCCA -> GGGGCCGCCAA
AGGGGGTATCG -> GGGGGTATCGA
AGGGTAAGGGT -> GGGTAAGGGTC
AGGGTCACCTC -> GGGTCACCTCC
AGGGTCTCGTT -> GGGTCTCGTTA
AGGTCAAAAAA -> GGTCAAAAAAC
AGGTCAAGTGG -> GGTCAAGTGGT
AGGTCCACGGT -> GGTCCACGGTG
AGGTCTGGACT -> GGTCTGGACTG
AGGTGGAGATA -> GGTGGAGATAC
AGGTGGCGCCG -> GGTGGCGCCGA
AGGTTGATATT -> GGTTGATATTC
AGTAAAACCAT -> GTAAAACCATA
AGTAAGCTGGT -> GTAAGCTGGTA
AGTACAGAATA -> GTACAGAATAC
AGTACATTCTT -> GTACATTCTTC
AGTACCATCTA -> GTACCATCTAC
AGTACCTCGAG -> GTACCTCGAGA
AGTAGGCCTTG -> GTAGGCCTTGG
AGTCAAACGAC -> GTCAAACGACG
AGTCACCTATG -> GTCACCTATGA
AGTCATTTGGG -> GTCATTTGGGG
AGTCCCACCTC -> GTCCCACCTCA
AGTCCCGTTGT -> GTCCCGTTGTC
AGTCTAATCCC -> GTCTAATCCCC
AGTCTGGCATA -> GTCTGGCATAT
AGTGCATATCC -> GTGCATATCCA
AGTGCCGACCA -> GTGCCGACCAG
AGTGGTCCGAA -> GTGGTCCGAAC
AGTGTAAGTGT -> GTGTAAGTGTT
AGTGTCCTTCA -> GTGTCCTTCAT
AGTGTTCGTAT -> GTGTTCGTATA
AGTTAAAATTA -> GTTAAAATTAG
AGTTCCGCCTA -> GTTCCGCCTAG
AGTTGTCAGAT -> GTTGTCAGATG
AGTTTTATGGA -> GTTTTATGGAC
AGTTTTATGTC -> GTTTTATGTCC
ATAACAATCTC -> TAACAATCTCT
ATAACTATGGT -> TAACTATGGTT
ATAACTTAGCT -> TAACTTAGCTT
ATAAGAAGAAG -> TAAGAAGAAGC
ATAAGATAATG -> TAAGATAATGT
ATAAGCACTAT -> TAAGCACTATA
ATAAGCATAGA -> TAAGCATAGAG
ATAAGCGGCCA -> TAAGCGGCCAG
ATAATGTTTGG -> TAATGTTTGGA
ATACACGCCTC -> TACACGCCTCA
ATACATATAAG -> TACATATAAGC
ATACCAGAAAA -> TACCAGAAAAA
ATACCCCAACG -> TACCCCAACGT
ATACCCCAGGT -> TACCCCAGGTC
ATACCGCGGCG -> TACCGCGGCGG
ATACCGGAAAA -> TACCGGAAAAA
ATACCTGAATA -> TACCTGAATAT
ATACGCGAAAT -> TACGCGAAATT
ATACGTCCAGG -> TACGTCCAGGC
ATACTGTACAC -> TACTGTACACA
ATAGACTATGC -> TAGACTATGCC
ATAGAGCGCGG -> TAGAGCGCGGG
ATAGGAGGCCG -> TAGGAGGCCGA
ATAGGGGCCGC -> TAGGGGCCGCC
ATAGTAAGCTG -> TAGTAAGCTGG
ATAGTACAGAA -> TAGTACAGAAT
ATAGTCATTTG -> TAGTCATTTGG
ATAGTCCCACC -> TAGTCCCACCT
ATATAAGCACT -> TATAAGCACTA
ATATAGACTAT -> TATAGACTATG
ATATCCATGGA -> TATCCATGGAC
ATATGCCCGCC -> TATGCCCGCCA
ATATGCCTTTA -> TATGCCTTTAC
ATATGCGCTAC -> TATGCGCTACG
ATATGGTATGG -> TATGGTATGGC
ATATGTTAACT -> TATGTTAACTT
ATATTCACCCT -> TATTCACCCTA
ATATTCATTAA -> TATTCATTAAG
ATCAAACTTGA -> TCAAACTTGAC
ATCAATAAGAT -> TCAATAAGATA
ATCAATCAAAC -> TCAATCAAACT
ATCAATTTGGG -> TCAATTTGGGA
ATCACCCCGGG -> TCACCCCGGGT
ATCACGCATGT -> TCACGCATGTG
ATCACTATCTC -> TCACTATCTCC
ATCATTCTAAG -> TCATTCTAAGG
ATCCAAATCGA -> TCCAAATCGAG
ATCCATGGACG -> TCCATGGACGC
ATCCCCAACTT -> TCCCCAACTTT
ATCCGCAGGGG -> TCCGCAGGGGG
ATCCGCGTACG -> TCCGCGTACGT
ATCCGGGAGCG -> TCCGGGAGCGG
ATCCTTTGCCT -> TCCTTTGCCTC
ATCGAATCAAT -> TCGAATCAATC
ATCGAGCTCGA -> TCGAGCTCGAC
ATCGATATGCG -> TCGATATGCGC
ATCGATGTTAA -> TCGATGTTAAG
ATCGCAGTTAA -> TCGCAGTTAAA
ATCGGCTGCTC -> TCGGCTGCTCG
ATCGGGGGTGC -> TCGGGGGTGCT
ATCGTGTGTGT -> TCGTGTGTGTT
ATCGTGTTCTC -> TCGTGTTCTCA
ATCTAATACCA -> TCTAATACCAG
ATCTACACTGA -> TCTACACTGAT
ATCTCCTTGTA -> TCTCCTTGTAT
ATCTCGCCACT -> TCTCGCCACTG
ATCTCTGTTCC -> TCTCTGTTCCG
ATCTGATGAAC -> TCTGATGAACC
ATCTGTCTTGC -> TCTGTCTTGCG
ATCTTGGATCG -> TCTTGGATCGA
ATGAAACGGGT -> TGAAACGGGTA
ATGAACCGGTC -> TGAACCGGTCC
ATGACCATGCG -> TGACCATGCGT
ATGACGGTTCG -> TGACGGTTCGG
ATGAGAGTGCA -> TGAGAGTGCAT
ATGAGCATGTC -> TGAGCATGTCG
ATGATACCCCA -> TGATACCCCAG
ATGATCATTCT -> TGATCATTCTA
ATGATCCTTTG -> TGATCCTTTGC
ATGATTCAGAC -> TGATTCAGACT
ATGCCCACCTT -> TGCCCACCTTG
ATGCCCGCCAA -> TGCCCGCCAAC
ATGCCTCTATG -> TGCCTCTATGC
ATGCCTTTACC -> TGCCTTTACCA
ATGCGCGAGAA -> TGCGCGAGAAC
ATGCGCTACGT -> TGCGCTACGTA
ATGCGTGTGAG -> TGCGTGTGAGG
ATGCTATTAAG -> TGCTATTAAGT
ATGCTTCGCAT -> TGCTTCGCATC
ATGGACACTTC -> TGGACACTTCA
ATGGACGCTAC -> TGGACGCTACG
ATGGATCCGCA -> TGGATCCGCAG
ATGGCCAAAAC -> TGGCCAAAACG
ATGGCCTCGGA -> TGGCCTCGGAT
ATGGCGGGAGG -> TGGCGGGAGGG
ATGGTATGGCC -> TGGTATGGCCA
ATGGTGTGCTG -> TGGTGTGCTGC
ATGGTTGAGAG -> TGGTTGAGAGG
ATGGTTTCCAC -> TGGTTTCCACA
ATGTAATCAAT -> TGTAATCAATA
ATGTCAACAGA -> TGTCAACAGAA
ATGTCAGCATG -> TGTCAGCATGA
ATGTCCGCTAT -> TGTCCGCTATT
ATGTCGTCAGC -> TGTCGTCAGCC
ATGTCTAAGGT -> TGTCTAAGGTC
ATGTGATCGTG -> TGTGATCGTGT
ATGTTAACTTC -> TGTTAACTTCT
ATGTTAAGGTC -> TGTTAAGGTCA
ATGTTTACGCT -> TGTTTACGCTT
ATGTTTGGAAA -> TGTTTGGAAAC
ATTAAGGGGAA -> TTAAGGGGAAA
ATTAAGTTTTA -> TTAAGTTTTAT
ATTAGAAGCAC -> TTAGAAGCACG
ATTAGCGAAGC -> TTAGCGAAGCC
ATTATAGTAAG -> TTATAGTAAGC
ATTATCACCCC -> TTATCACCCCG
ATTATCTGTCT -> TTATCTGTCTT
ATTATTATAGT -> TTATTATAGTA
ATTCAATACGC -> TTCAATACGCG
ATTCACCCTAG -> TTCACCCTAGG
ATTCACGTCTT -> TTCACGTCTTG
ATTCAGACTCA -> TTCAGACTCAA
ATTCATTAAGG -> TTCATTAAGGG
ATTCCAATCGT -> TTCCAATCGTG
ATTCCGAGCCG -> TTCCGAGCCGT
ATTCCGATGGA -> TTCCGATGGAT
ATTCGAATCTT -> TTCGAATCTTG
ATTCGGTGGTA -> TTCGGTGGTAC
ATTCGTCGATC -> TTCGTCGATCC
ATTCGTTCGTG -> TTCGTTCGTGG
ATTCTAAGGAA -> TTCTAAGGAAG
ATTCTCGTTTG -> TTCTCGTTTGC
ATTCTTACGGC -> TTCTTACGGCA
ATTCTTCGGTA -> TTCTTCGGTAG
ATTGAAGTAGG -> TTGAAGTAGGC
ATTGAGCATTC -> TTGAGCATTCA
ATTGAGGAATT -> TTGAGGAATTG
ATTGCCATTCT -> TTGCCATTCTT
ATTGGCGCATT -> TTGGCGCATTC
ATTGGTATGCT -> TTGGTATGCTA
ATTGTCAATTC -> TTGTCAATTCG
ATTTCCTAGCC -> TTTCCTAGCCC
ATTTCGGAAGC -> TTTCGGAAGCT
ATTTGGGAATC -> TTTGGGAATCT
ATTTGGGGTAC -> TTTGGGGTACG
CAAAAAACATA -> AAAAAACATAC
CAAAACGTTCG -> AAAACGTTCGA
CAAACGACGAT -> AAACGACGATT
CAAACTTGACT -> AAACTTGACTG
CAAAGACAGAG -> AAAGACAGAGA
CAAAGCCACGA -> AAAGCCACGAT
CAAAGTACATT -> AAAGTACATTC
CAAATACCCCA -> AAATACCCCAA
CAAATCGAGCT -> AAATCGAGCTC
CAAATGTTTAC -> AAATGTTTACG
CAACAGAAGGT -> AACAGAAGGTC
CAACAGAATAG -> AACAGAATAGT
CAACCGAATAT -> AACCGAATATG
CAACGTCCCAG -> AACGTCCCAGG
CAACGTCTGGT -> AACGTCTGGTC
CAACTCGATAA -> AACTCGATAAG
CAACTTTTATC -> AACTTTTATCA
CAAGACTCTCC -> AAGACTCTCCG
CAAGAGCAGCC -> AAGAGCAGCCC
CAAGAGTCTAA -> AAGAGTCTAAT
CAAGATTGAAG -> AAGATTGAAGT
CAAGCTATGCT -> AAGCTATGCTT
CAAGTGGTCCG -> AAGTGGTCCGA
CAATAACTTAG -> AATAACTTAGC
CAATAAGATAA -> AATAAGATAAT
CAATAAGCGGC -> AATAAGCGGCC
CAATACGCGAA -> AATACGCGAAA
CAATCAAACTT -> AATCAAACTTG
CAATCGTGTTC -> AATCGTGTTCT
CAATCTCTGTT -> AATCTCTGTTC
CAATGAGAGTG -> AATGAGAGTGC
CAATTCGGTGG -> AATTCGGTGGT
CAATTCTCGTT -> AATTCTCGTTT
CAATTTGGGAA -> AATTTGGGAAT
CACAACCGAAT -> ACAACCGAATA
CACAGGACGAC -> ACAGGACGACC
CACATATAGAC -> ACATATAGACT
CACATCACTAT -> ACATCACTATC
CACATGTCTAA -> ACATGTCTAAG
CACCCCGGGTA -> ACCCCGGGTAG
CACCCTAGGTG -> ACCCTAGGTGG
CACCGTAAATA -> ACCGTAAATAC
CACCTATGAAA -> ACCTATGAAAC
CACCTCAGAAG -> ACCTCAGAAGT
CACCTCCTTTC -> ACCTCCTTTCC
CACCTTGTGGT -> ACCTTGTGGTC
CACGATCCAAA -> ACGATCCAAAT
CACGCATGTGA -> ACGCATGTGAT
CACGCCTCACG -> ACGCCTCACGT
CACGGTCCCAG -> ACGGTCCCAGA
CACGGTGAAGC -> ACGGTGAAGCC
CACGTAAAATC -> ACGTAAAATCG
CACGTCTTGCT -> ACGTCTTGCTT
CACTATCTCCT -> ACTATCTCCTT
CACTGATCGCA -> ACTGATCGCAG
CACTGATGATC -> ACTGATGATCA
CACTGGGTCTA -> ACTGGGTCTAA
CACTTCACAGG -> ACTTCACAGGA
CAGAAAAAAGA -> AGAAAAAAGAT
CAGAAGGTCCA -> AGAAGGTCCAC
CAGAAGTTCCG -> AGAAGTTCCGC
CAGAATACTGT -> AGAATACTGTA
CAGAATAGTCC -> AGAATAGTCCC
CAGAATGGCGG -> AGAATGGCGGG
CAGACTCAATG -> AGACTCAATGA
CAGAGACATGT -> AGAGACATGTC
CAGATGTCAGC -> AGATGTCAGCA
CAGCACCGTAA -> AGCACCGTAAA
CAGCATGATTC -> AGCATGATTCA
CAGCCATAGGA -> AGCCATAGGAG
CAGCCATTATC -> AGCCATTATCT
CAGCCCTACAG -> AGCCCTACAGG
CAGCGTGATTG -> AGCGTGATTGT
CAGGACGACCT -> AGGACGACCTC
CAGGATATGTT -> AGGATATGTTA
CAGGATGGTGT -> AGGATGGTGTG
CAGGCCCCCAT -> AGGCCCCCATA
CAGGGCTTACA -> AGGGCTTACAT
CAGGGGGTATC -> AGGGGGTATCG
CAGGGTAAGGG -> AGGGTAAGGGT
CAGGGTCTCGT -> AGGGTCTCGTT
CAGGTCAAGTG -> AGGTCAAGTGG
CAGTAAAACCA -> AGTAAAACCAT
CAGTACCATCT -> AGTACCATCTA
CAGTCAAACGA -> AGTCAAACGAC
CAGTCACCTAT -> AGTCACCTATG
CAGTGCCGACC -> AGTGCCGACCA
CAGTTAAAATT -> AGTTAAAATTA
CAGTTGTCAGA -> AGTTGTCAGAT
CAGTTTTATGG -> AGTTTTATGGA
CATAACAATCT -> ATAACAATCTC
CATAACTATGG -> ATAACTATGGT
CATAAGCATAG -> ATAAGCATAGA
CATACATATAA -> ATACATATAAG
CATACCGCGGC -> ATACCGCGGCG
CATACCTGAAT -> ATACCTGAATA
CATAGAGCGCG -> ATAGAGCGCGG
CATAGGAGGCC -> ATAGGAGGCCG
CATAGTACAGA -> ATAGTACAGAA
CATATAAGCAC -> ATATAAGCACT
CATATAGACTA -> ATATAGACTAT
CATATCCATGG -> ATATCCATGGA
CATATGCCTTT -> ATATGCCTTTA
CATCACTATCT -> ATCACTATCTC
CATCTACACTG -> ATCTACACTGA
CATCTCGCCAC -> ATCTCGCCACT
CATGACGGTTC -> ATGACGGTTCG
CATGAGCATGT -> ATGAGCATGTC
CATGATACCCC -> ATGATACCCCA
CATGATCCTTT -> ATGATCCTTTG
CATGATTCAGA -> ATGATTCAGAC
CATGCCCACCT -> ATGCCCACCTT
CATGCGTGTGA -> ATGCGTGTGAG
CATGGACGCTA -> ATGGACGCTAC
CATGTAATCAA -> ATGTAATCAAT
CATGTCAACAG -> ATGTCAACAGA
CATGTCGTCAG -> ATGTCGTCAGC
CATGTCTAAGG -> ATGTCTAAGGT
CATGTGATCGT -> ATGTGATCGTG
CATTAAGGGGA -> ATTAAGGGGAA
CATTATCACCC -> ATTATCACCCC
CATTATCTGTC -> ATTATCTGTCT
CATTCACGTCT -> ATTCACGTCTT
CATTCCGAGCC -> ATTCCGAGCCG
CATTCCGATGG -> ATTCCGATGGA
CATTCTAAGGA -> ATTCTAAGGAA
CATTCTTACGG -> ATTCTTACGGC
CATTCTTCGGT -> ATTCTTCGGTA
CATTGGTATGC -> ATTGGTATGCT
CATTTCGGAAG -> ATTTCGGAAGC
CATTTGGGGTA -> ATTTGGGGTAC
CCAAAACGTTC -> CAAAACGTTCG
CCAAATCGAGC -> CAAATCGAGCT
CCAACAGAATA -> CAACAGAATAG
CCAACGTCCCA -> CAACGTCCCAG
CCAACGTCTGG -> CAACGTCTGGT
CCAACTCGATA -> CAACTCGATAA
CCAACTTTTAT -> CAACTTTTATC
CCAAGAGCAGC -> CAAGAGCAGCC
CCAAGATTGAA -> CAAGATTGAAG
CCAAGCTATGC -> CAAGCTATGCT
CCAATCGTGTT -> CAATCGTGTTC
CCACATATAGA -> CACATATAGAC
CCACATGTCTA -> CACATGTCTAA
CCACCTCAGAA -> CACCTCAGAAG
CCACCTTGTGG -> CACCTTGTGGT
CCACGATCCAA -> CACGATCCAAA
CCACGGTGAAG -> CACGGTGAAGC
CCACTGATCGC -> CACTGATCGCA
CCAGAAAAAAG -> CAGAAAAAAGA
CCAGAATGGCG -> CAGAATGGCGG
CCAGGCCCCCA -> CAGGCCCCCAT
CCAGGGTAAGG -> CAGGGTAAGGG
CCAGGTCAAGT -> CAGGTCAAGTG
CCAGTACCATC -> CAGTACCATCT
CCAGTCAAACG -> CAGTCAAACGA
CCAGTTTTATG -> CAGTTTTATGG
CCATAACTATG -> CATAACTATGG
CCATACCGCGG -> CATACCGCGGC
CCATACCTGAA -> CATACCTGAAT
CCATAGGAGGC -> CATAGGAGGCC
CCATAGTACAG -> CATAGTACAGA
CCATCTACACT -> CATCTACACTG
CCATGATCCTT -> CATGATCCTTT
CCATGCGTGTG -> CATGCGTGTGA
CCATGGACGCT -> CATGGACGCTA
CCATTATCTGT -> CATTATCTGTC
CCATTCTTACG -> CATTCTTACGG
CCATTTCGGAA -> CATTTCGGAAG
CCCAACGTCTG -> CCAACGTCTGG
CCCAACTTTTA -> CCAACTTTTAT
CCCACCTCAGA -> CCACCTCAGAA
CCCACCTTGTG -> CCACCTTGTGG
CCCAGAATGGC -> CCAGAATGGCG
CCCAGGGTAAG -> CCAGGGTAAGG
CCCAGGTCAAG -> CCAGGTCAAGT
CCCATACCGCG -> CCATACCGCGG
CCCATTTCGGA -> CCATTTCGGAA
CCCCAACGTCT -> CCCAACGTCTG
CCCCAACTTTT -> CCCAACTTTTA
CCCCAGGTCAA -> CCCAGGTCAAG
CCCCATACCGC -> CCCATACCGCG
CCCCCATACCG -> CCCCATACCGC
CCCCGGGTAGG -> CCCGGGTAGGA
CCCCGTTTATT -> CCCGTTTATTG
CCCGAGCTGGC -> CCGAGCTGGCC
CCCGCCAACTC -> CCGCCAACTCG
CCCGGGTAGGA -> CCGGGTAGGAA
CCCGTTGTCAG -> CCGTTGTCAGT
CCCGTTTATTG -> CCGTTTATTGA
CCCTACAGGAT -> CCTACAGGATA
CCCTAGGTGGA -> CCTAGGTGGAG
CCGAACTCAAA -> CGAACTCAAAG
CCGAAGCAATT -> CGAAGCAATTC
CCGAATATGGT -> CGAATATGGTA
CCGACCAGTCA -> CGACCAGTCAA
CCGACCGATTA -> CGACCGATTAT
CCGACGCATTA -> CGACGCATTAT
CCGAGCCGTTG -> CGAGCCGTTGT
CCGAGCTGGCC -> CGAGCTGGCCA
CCGATGGATCC -> CGATGGATCCG
CCGATGGTTGA -> CGATGGTTGAG
CCGATTATTAT -> CGATTATTATA
CCGATTTCCTA -> CGATTTCCTAG
CCGCAGGGGGT -> CGCAGGGGGTA
CCGCCAACTCG -> CGCCAACTCGA
CCGCCAAGCTA -> CGCCAAGCTAT
CCGCCCATTTC -> CGCCCATTTCG
CCGCCTAAGTC -> CGCCTAAGTCC
CCGCCTAGGGA -> CGCCTAGGGAG
CCGCGGCGGCT -> CGCGGCGGCTT
CCGCGTACGTG -> CGCGTACGTGT
CCGCTATTCGT -> CGCTATTCGTC
CCGGAAAAATT -> CGGAAAAATTA
CCGGGAGCGGG -> CGGGAGCGGGC
CCGGGGAACTT -> CGGGGAACTTA
CCGGGTAGGAA -> CGGGTAGGAAC
CCGGTCCTTTT -> CGGTCCTTTTC
CCGGTGCTCAA -> CGGTGCTCAAA
CCGTAAATACC -> CGTAAATACCG
CCGTCACATCA -> CGTCACATCAC
CCGTGAAACTG -> CGTGAAACTGG
CCGTTCGGCAT -> CGTTCGGCATG
CCGTTCGGCCG -> CGTTCGGCCGG
CCGTTGTCAGT -> CGTTGTCAGTG
CCGTTGTCTGA -> CGTTGTCTGAA
CCGTTTATTGA -> CGTTTATTGAG
CCTAAGTCCCG -> CTAAGTCCCGT
CCTACAGGATA -> CTACAGGATAT
CCTAGCCCCGT -> CTAGCCCCGTT
CCTAGGGAGTG -> CTAGGGAGTGT
CCTAGGTGGAG -> CTAGGTGGAGA
CCTATGAAACG -> CTATGAAACGG
CCTCACGTAAA -> CTCACGTAAAA
CCTCAGAAGTT -> CTCAGAAGTTC
CCTCAGCACCG -> CTCAGCACCGT
CCTCCACATGT -> CTCCACATGTC
CCTCCTTTCCG -> CTCCTTTCCGT
CCTCGAGACTG -> CTCGAGACTGT
CCTCGCTGGCG -> CTCGCTGGCGT
CCTCGGATCCG -> CTCGGATCCGG
CCTCTATGCGC -> CTCTATGCGCG
CCTGAATATTC -> CTGAATATTCA
CCTTCATGTAA -> CTTCATGTAAT
CCTTGGAGAAT -> CTTGGAGAATC
CCTTGTATTCA -> CTTGTATTCAA
CCTTGTGGTCC -> CTTGTGGTCCG
CCTTTACCAAG -> CTTTACCAAGA
CCTTTCCGTTC -> CTTTCCGTTCG
CCTTTGCCTCA -> CTTTGCCTCAG
CCTTTTCCGAT -> CTTTTCCGATT
CGAAATTGAGC -> GAAATTGAGCA
CGAACTCAAAG -> GAACTCAAAGA
CGAAGCAATTC -> GAAGCAATTCT
CGAAGCCGATG -> GAAGCCGATGG
CGAATATGGTA -> GAATATGGTAT
CGAATCAATCA -> GAATCAATCAA
CGAATCTTGGA -> GAATCTTGGAT
CGACCAGTCAA -> GACCAGTCAAA
CGACCGATTAT -> GACCGATTATT
CGACCGCCCAT -> GACCGCCCATT
CGACCTCGCTG -> GACCTCGCTGG
CGACGATTGGC -> GACGATTGGCG
CGACGCATTAT -> GACGCATTATC
CGAGAACGGGT -> GAGAACGGGTT
CGAGACACTGG -> GAGACACTGGG
CGAGACTGTTC -> GAGACTGTTCG
CGAGCCGTTGT -> GAGCCGTTGTC
CGAGCTCGACC -> GAGCTCGACCG
CGAGCTGGCCA -> GAGCTGGCCAA
CGAGGTTGATA -> GAGGTTGATAT
CGATAAGAAGA -> GATAAGAAGAA
CGATATGCGCT -> GATATGCGCTA
CGATCCAAATC -> GATCCAAATCG
CGATCCGCGTA -> GATCCGCGTAC
CGATCTGATGA -> GATCTGATGAA
CGATGGATCCG -> GATGGATCCGC
CGATGGTTGAG -> GATGGTTGAGA
CGATGTTAAGG -> GATGTTAAGGT
CGATTATTATA -> GATTATTATAG
CGATTGGCGCA -> GATTGGCGCAT
CGATTTCCTAG -> GATTTCCTAGC
CGCAGGGGGTA -> GCAGGGGGTAT
CGCAGTTAAAA -> GCAGTTAAAAT
CGCATCTCGCC -> GCATCTCGCCA
CGCATGTGATC -> GCATGTGATCG
CGCATTATCAC -> GCATTATCACC
CGCATTCCGAG -> GCATTCCGAGC
CGCCAACTCGA -> GCCAACTCGAT
CGCCAAGCTAT -> GCCAAGCTATG
CGCCACTGATC -> GCCACTGATCG
CGCCATAGTAC -> GCCATAGTACA
CGCCCATTTCG -> GCCCATTTCGG
CGCCGACCGAT -> GCCGACCGATT
CGCCTAAGTCC -> GCCTAAGTCCC
CGCCTAGGGAG -> GCCTAGGGAGT
CGCCTCACGTA -> GCCTCACGTAA
CGCCTCCACAT -> GCCTCCACATG
CGCGAAATTGA -> GCGAAATTGAG
CGCGAGAACGG -> GCGAGAACGGG
CGCGGCGGCTT -> GCGGCGGCTTG
CGCGGGTCGTG -> GCGGGTCGTGG
CGCGTACGTGT -> GCGTACGTGTC
CGCTACGGTTC -> GCTACGGTTCG
CGCTACGTAGC -> GCTACGTAGCA
CGCTATAGTCA -> GCTATAGTCAT
CGCTATTCGTC -> GCTATTCGTCG
CGCTGGCGTTT -> GCTGGCGTTTA
CGCTTGCAGTA -> GCTTGCAGTAA
CGGAAAAATTA -> GGAAAAATTAG
CGGAAGCTGGG -> GGAAGCTGGGG
CGGATCCGGGA -> GGATCCGGGAG
CGGATCGGCTG -> GGATCGGCTGC
CGGCAGGATGG -> GGCAGGATGGT
CGGCATGACGG -> GGCATGACGGT
CGGCCAGTACC -> GGCCAGTACCA
CGGCCGGTGCT -> GGCCGGTGCTC
CGGCGGCTTGT -> GGCGGCTTGTA
CGGCTGCTCGT -> GGCTGCTCGTT
CGGCTTGTAAG -> GGCTTGTAAGT
CGGGAGCGGGC -> GGGAGCGGGCT
CGGGAGGGAAA -> GGGAGGGAAAC
CGGGATCACGC -> GGGATCACGCA
CGGGCTGCCAT -> GGGCTGCCATA
CGGGGAACTTA -> GGGGAACTTAC
CGGGGCGTCCA -> GGGGCGTCCAA
CGGGGGTGCTG -> GGGGGTGCTGG
CGGGTACAAAG -> GGGTACAAAGC
CGGGTAGGAAC -> GGGTAGGAACA
CGGGTCGTGGC -> GGGTCGTGGCA
CGGGTTGCAAT -> GGGTTGCAATA
CGGTAGGACGC -> GGTAGGACGCT
CGGTCCCAGAA -> GGTCCCAGAAT
CGGTCCTTTTC -> GGTCCTTTTCC
CGGTGAAGCCG -> GGTGAAGCCGT
CGGTGCTCAAA -> GGTGCTCAAAT
CGGTGGTACCG -> GGTGGTACCGG
CGGTTCGAGAC -> GGTTCGAGACA
CGGTTCGGGAT -> GGTTCGGGATC
CGGTTTGCGTT -> GGTTTGCGTTC
CGTAAAATCGA -> GTAAAATCGAT
CGTAAATACCG -> GTAAATACCGG
CGTACGTGTCT -> GTACGTGTCTG
CGTAGCATGCC -> GTAGCATGCCC
CGTATACACGC -> GTATACACGCC
CGTCACATCAC -> GTCACATCACT
CGTCAGCCATT -> GTCAGCCATTA
CGTCCAAGAGC -> GTCCAAGAGCA
CGTCCAGGCCC -> GTCCAGGCCCC
CGTCCCAGGGT -> GTCCCAGGGTA
CGTCGATCCGC -> GTCGATCCGCG
CGTCTGGTCCC -> GTCTGGTCCCG
CGTCTTGCTTT -> GTCTTGCTTTC
CGTGAAACTGG -> GTGAAACTGGT
CGTGATTGTCA -> GTGATTGTCAA
CGTGGATTCGA -> GTGGATTCGAA
CGTGGCAGTCA -> GTGGCAGTCAC
CGTGGTGCTTT -> GTGGTGCTTTA
CGTGTCTGTGA -> GTGTCTGTGAA
CGTGTGAGGTG -> GTGTGAGGTGG
CGTGTGTGTTA -> GTGTGTGTTAT
CGTGTTCTCAG -> GTGTTCTCAGG
CGTTACAAGAC -> GTTACAAGACT
CGTTACGATCT -> GTTACGATCTG
CGTTCGAGGTT -> GTTCGAGGTTG
CGTTCGGCATG -> GTTCGGCATGA
CGTTCGGCCGG -> GTTCGGCCGGT
CGTTCGTGGTG -> GTTCGTGGTGC
CGTTCTAAATA -> GTTCTAAATAG
CGTTGTCAGTG -> GTTGTCAGTGC
CGTTGTCTGAA -> GTTGTCTGAAG
CGTTTACAGTT -> GTTTACAGTTG
CGTTTACATAA -> GTTTACATAAC
CGTTTATTGAG -> GTTTATTGAGG
CGTTTGCGTTT -> GTTTGCGTTTA
CTAAATAGGGG -> TAAATAGGGGC
CTAAGGAAGTA -> TAAGGAAGTAC
CTAAGGTCTGG -> TAAGGTCTGGA
CTAAGTCCCGT -> TAAGTCCCGTT
CTAATACCAGA -> TAATACCAGAA
CTAATCCCCAA -> TAATCCCCAAC
CTAATTCGTTC -> TAATTCGTTCG
CTACACTGATG -> TACACTGATGA
CTACAGGATAT -> TACAGGATATG
CTACGGTTCGA -> TACGGTTCGAG
CTACGTAGCAT -> TACGTAGCATG
CTAGCAAAGTA -> TAGCAAAGTAC
CTAGCCCCGTT -> TAGCCCCGTTT
CTAGGGAGTGT -> TAGGGAGTGTC
CTAGGTGGAGA -> TAGGTGGAGAT
CTATAGTCATT -> TATAGTCATTT
CTATCTCCTTG -> TATCTCCTTGT
CTATGAAACGG -> TATGAAACGGG
CTATGCCTCTA -> TATGCCTCTAT
CTATGCGCGAG -> TATGCGCGAGA
CTATGCTTCGC -> TATGCTTCGCA
CTATGGCCTCG -> TATGGCCTCGG
CTATGGTTTCC -> TATGGTTTCCA
CTATTAAGTTT -> TATTAAGTTTT
CTATTCGTCGA -> TATTCGTCGAT
CTCAAAGACAG -> TCAAAGACAGA
CTCAAATGTTT -> TCAAATGTTTA
CTCAATGAGAG -> TCAATGAGAGT
CTCACGTAAAA -> TCACGTAAAAT
CTCAGAAGTTC -> TCAGAAGTTCC
CTCAGCACCGT -> TCAGCACCGTA
CTCAGGGCTTA -> TCAGGGCTTAC
CTCATGATACC -> TCATGATACCC
CTCCACATGTC -> TCCACATGTCT
CTCCGTCACAT -> TCCGTCACATC
CTCCTTGTATT -> TCCTTGTATTC
CTCCTTTCCGT -> TCCTTTCCGTT
CTCGACCGCCC -> TCGACCGCCCA
CTCGAGACTGT -> TCGAGACTGTT
CTCGATAAGAA -> TCGATAAGAAG
CTCGCCACTGA -> TCGCCACTGAT
CTCGCTGGCGT -> TCGCTGGCGTT
CTCGGATCCGG -> TCGGATCCGGG
CTCGTTACAAG -> TCGTTACAAGA
CTCGTTACGAT -> TCGTTACGATC
CTCGTTTGCGT -> TCGTTTGCGTT
CTCTATGCGCG -> TCTATGCGCGA
CTCTCATGATA -> TCTCATGATAC
CTCTCCGTCAC -> TCTCCGTCACA
CTCTGTTCCGT -> TCTGTTCCGTT
CTGAAGACCGA -> TGAAGACCGAC
CTGAAGCGGTT -> TGAAGCGGTTT
CTGAATATTCA -> TGAATATTCAT
CTGATCGCAGT -> TGATCGCAGTT
CTGATGAACCG -> TGATGAACCGG
CTGATGATCAT -> TGATGATCATT
CTGCAATAAGC -> TGCAATAAGCG
CTGCCAACGTC -> TGCCAACGTCC
CTGCCATACCT -> TGCCATACCTG
CTGCTCGTTAC -> TGCTCGTTACA
CTGGACTGCCA -> TGGACTGCCAA
CTGGCATATGC -> TGGCATATGCC
CTGGCCAACAG -> TGGCCAACAGA
CTGGCCATGAT -> TGGCCATGATC
CTGGCGTTTAC -> TGGCGTTTACA
CTGGCTTCGGG -> TGGCTTCGGGG
CTGGGGTTAGT -> TGGGGTTAGTG
CTGGGTCTAAT -> TGGGTCTAATT
CTGGTACATTC -> TGGTACATTCC
CTGGTCCCGAG -> TGGTCCCGAGC
CTGGTGGTAAA -> TGGTGGTAAAA
CTGTACACAAC -> TGTACACAACC
CTGTCTTGCGC -> TGTCTTGCGCC
CTGTGAACTAG -> TGTGAACTAGC
CTGTTCCGTTC -> TGTTCCGTTCG
CTGTTCGTGGA -> TGTTCGTGGAT
CTTACATGAGC -> TTACATGAGCA
CTTACGGCAGG -> TTACGGCAGGA
CTTACTGGCTT -> TTACTGGCTTC
CTTAGCTTTCG -> TTAGCTTTCGG
CTTCACAGGAC -> TTCACAGGACG
CTTCATGTAAT -> TTCATGTAATC
CTTCGCATCTC -> TTCGCATCTCG
CTTCGGGGCGT -> TTCGGGGCGTC
CTTCGGTAGGA -> TTCGGTAGGAC
CTTCTATGGCC -> TTCTATGGCCT
CTTGACTGAAG -> TTGACTGAAGC
CTTGCAGTAAA -> TTGCAGTAAAA
CTTGCGCCATA -> TTGCGCCATAG
CTTGCTTTCAG -> TTGCTTTCAGG
CTTGGAGAATC -> TTGGAGAATCG
CTTGGATCGAT -> TTGGATCGATA
CTTGTAAGTCT -> TTGTAAGTCTG
CTTGTATTCAA -> TTGTATTCAAT
CTTGTGGTCCG -> TTGTGGTCCGC
CTTTACAAGAG -> TTTACAAGAGT
CTTTACCAAGA -> TTTACCAAGAT
CTTTCAGGGTC -> TTTCAGGGTCT
CTTTCCGTTCG -> TTTCCGTTCGG
CTTTCGGATCG -> TTTCGGATCGG
CTTTGCCTCAG -> TTTGCCTCAGC
CTTTTATCAAT -> TTTTATCAATT
CTTTTCCGATT -> TTTTCCGATTT
GAAAAAAGATA -> AAAAAAGATAT
GAAAAATTAGC -> AAAAATTAGCG
GAAACAGCCAT -> AAACAGCCATA
GAAACATTGGT -> AAACATTGGTA
GAAACGGGTAC -> AAACGGGTACA
GAAACTCTCAT -> AAACTCTCATG
GAAACTGGTGG -> AAACTGGTGGT
GAAATTGAGCA -> AAATTGAGCAT
GAACAGCGTGA -> AACAGCGTGAT
GAACCGGTCCT -> AACCGGTCCTT
GAACGGGTTGC -> AACGGGTTGCA
GAACTAGCAAA -> AACTAGCAAAG
GAACTCAAAGA -> AACTCAAAGAC
GAACTTACTGG -> AACTTACTGGC
GAAGAAGCAAA -> AAGAAGCAAAT
GAAGACCGACG -> AAGACCGACGC
GAAGCAAATAC -> AAGCAAATACC
GAAGCAATTCT -> AAGCAATTCTC
GAAGCACGGTC -> AAGCACGGTCC
GAAGCCGATGG -> AAGCCGATGGT
GAAGCCGTGAA -> AAGCCGTGAAA
GAAGCGGTTTG -> AAGCGGTTTGC
GAAGCTGGGGT -> AAGCTGGGGTT
GAAGGTCCACG -> AAGGTCCACGG
GAAGTACCTCG -> AAGTACCTCGA
GAAGTAGGCCT -> AAGTAGGCCTT
GAAGTTCCGCC -> AAGTTCCGCCT
GAATACTGTAC -> AATACTGTACA
GAATAGTCCCA -> AATAGTCCCAC
GAATATGGTAT -> AATATGGTATG
GAATATTCATT -> AATATTCATTA
GAATCAATCAA -> AATCAATCAAA
GAATCGGGGGT -> AATCGGGGGTG
GAATCTAATAC -> AATCTAATACC
GAATCTTGGAT -> AATCTTGGATC
GAATGGCGGGA -> AATGGCGGGAG
GAATTGCCATT -> AATTGCCATTC
GACACTGGGTC -> ACACTGGGTCT
GACACTTCACA -> ACACTTCACAG
GACAGAGACAT -> ACAGAGACATG
GACATAAGCAT -> ACATAAGCATA
GACATGTCAAC -> ACATGTCAACA
GACCAGTCAAA -> ACCAGTCAAAC
GACCATGCGTG -> ACCATGCGTGT
GACCGACGCAT -> ACCGACGCATT
GACCGATTATT -> ACCGATTATTA
GACCGCCCATT -> ACCGCCCATTT
GACCTCGCTGG -> ACCTCGCTGGC
GACGACCTCGC -> ACGACCTCGCT
GACGATTGGCG -> ACGATTGGCGC
GACGCATTATC -> ACGCATTATCA
GACGCTACGGT -> ACGCTACGGTT
GACGCTATAGT -> ACGCTATAGTC
GACGGTTCGGG -> ACGGTTCGGGA
GACTATGCCTC -> ACTATGCCTCT
GACTCAATGAG -> ACTCAATGAGA
GACTCTCCGTC -> ACTCTCCGTCA
GACTGAAGCGG -> ACTGAAGCGGT
GACTGCCAACG -> ACTGCCAACGT
GACTGTTCGTG -> ACTGTTCGTGG
GAGAACGGGTT -> AGAACGGGTTG
GAGAATCGGGG -> AGAATCGGGGG
GAGACACTGGG -> AGACACTGGGT
GAGACATGTCA -> AGACATGTCAA
GAGACTGTTCG -> AGACTGTTCGT
GAGAGGAGGAT -> AGAGGAGGATG
GAGAGTGCATA -> AGAGTGCATAT
GAGATACGTCC -> AGATACGTCCA
GAGCAGCCCTA -> AGCAGCCCTAC
GAGCATGTCGT -> AGCATGTCGTC
GAGCATTCACG -> AGCATTCACGT
GAGCCGTTGTC -> AGCCGTTGTCT
GAGCGCGGGTC -> AGCGCGGGTCG
GAGCGGGCTGC -> AGCGGGCTGCC
GAGCTCGACCG -> AGCTCGACCGC
GAGCTGGCCAA -> AGCTGGCCAAC
GAGGAATTGCC -> AGGAATTGCCA
GAGGAGGATGA -> AGGAGGATGAC
GAGGATGACCA -> AGGATGACCAT
GAGGCCGAAGC -> AGGCCGAAGCA
GAGGGAAACAT -> AGGGAAACATT
GAGGTGGCGCC -> AGGTGGCGCCG
GAGGTTGATAT -> AGGTTGATATT
GAGTCTAATCC -> AGTCTAATCCC
GAGTGCATATC -> AGTGCATATCC
GAGTGTCCTTC -> AGTGTCCTTCA
GATAAGAAGAA -> ATAAGAAGAAG
GATAATGTTTG -> ATAATGTTTGG
GATACCCCAGG -> ATACCCCAGGT
GATACGTCCAG -> ATACGTCCAGG
GATATGCCCGC -> ATATGCCCGCC
GATATGCGCTA -> ATATGCGCTAC
GATATGTTAAC -> ATATGTTAACT
GATATTCACCC -> ATATTCACCCT
GATCACGCATG -> ATCACGCATGT
GATCATTCTAA -> ATCATTCTAAG
GATCCAAATCG -> ATCCAAATCGA
GATCCGCAGGG -> ATCCGCAGGGG
GATCCGCGTAC -> ATCCGCGTACG
GATCCGGGAGC -> ATCCGGGAGCG
GATCCTTTGCC -> ATCCTTTGCCT
GATCGATATGC -> ATCGATATGCG
GATCGCAGTTA -> ATCGCAGTTAA
GATCGGCTGCT -> ATCGGCTGCTC
GATCGTGTGTG -> ATCGTGTGTGT
GATCTGATGAA -> ATCTGATGAAC
GATGAACCGGT -> ATGAACCGGTC
GATGACCATGC -> ATGACCATGCG
GATGATCATTC -> ATGATCATTCT
GATGGATCCGC -> ATGGATCCGCA
GATGGTGTGCT -> ATGGTGTGCTG
GATGGTTGAGA -> ATGGTTGAGAG
GATGTCAGCAT -> ATGTCAGCATG
GATGTTAAGGT -> ATGTTAAGGTC
GATTATTATAG -> ATTATTATAGT
GATTCAGACTC -> ATTCAGACTCA
GATTCGAATCT -> ATTCGAATCTT
GATTGAAGTAG -> ATTGAAGTAGG
GATTGGCGCAT -> ATTGGCGCATT
GATTGTCAATT -> ATTGTCAATTC
GATTTCCTAGC -> ATTTCCTAGCC
GCAAAGTACAT -> CAAAGTACATT
GCAAATACCCC -> CAAATACCCCA
GCAATAACTTA -> CAATAACTTAG
GCAATAAGCGG -> CAATAAGCGGC
GCAATTCTCGT -> CAATTCTCGTT
GCACCGTAAAT -> CACCGTAAATA
GCACGGTCCCA -> CACGGTCCCAG
GCAGCCCTACA -> CAGCCCTACAG
GCAGGATGGTG -> CAGGATGGTGT
GCAGGGGGTAT -> CAGGGGGTATC
GCAGTAAAACC -> CAGTAAAACCA
GCAGTCACCTA -> CAGTCACCTAT
GCAGTTAAAAT -> CAGTTAAAATT
GCATAGAGCGC -> CATAGAGCGCG
GCATATCCATG -> CATATCCATGG
GCATATGCCTT -> CATATGCCTTT
GCATCTCGCCA -> CATCTCGCCAC
GCATGACGGTT -> CATGACGGTTC
GCATGATTCAG -> CATGATTCAGA
GCATGCCCACC -> CATGCCCACCT
GCATGTCGTCA -> CATGTCGTCAG
GCATGTGATCG -> CATGTGATCGT
GCATTATCACC -> CATTATCACCC
GCATTCACGTC -> CATTCACGTCT
GCATTCCGAGC -> CATTCCGAGCC
GCCAAAACGTT -> CCAAAACGTTC
GCCAACAGAAT -> CCAACAGAATA
GCCAACGTCCC -> CCAACGTCCCA
GCCAACTCGAT -> CCAACTCGATA
GCCAAGCTATG -> CCAAGCTATGC
GCCACGATCCA -> CCACGATCCAA
GCCACTGATCG -> CCACTGATCGC
GCCAGTACCAT -> CCAGTACCATC
GCCATACCTGA -> CCATACCTGAA
GCCATAGGAGG -> CCATAGGAGGC
GCCATAGTACA -> CCATAGTACAG
GCCATGATCCT -> CCATGATCCTT
GCCATTATCTG -> CCATTATCTGT
GCCATTCTTAC -> CCATTCTTACG
GCCCACCTTGT -> CCCACCTTGTG
GCCCATTTCGG -> CCCATTTCGGA
GCCCCCATACC -> CCCCCATACCG
GCCCCGTTTAT -> CCCCGTTTATT
GCCCGCCAACT -> CCCGCCAACTC
GCCCTACAGGA -> CCCTACAGGAT
GCCGAAGCAAT -> CCGAAGCAATT
GCCGACCAGTC -> CCGACCAGTCA
GCCGACCGATT -> CCGACCGATTA
GCCGATGGTTG -> CCGATGGTTGA
GCCGCCAAGCT -> CCGCCAAGCTA
GCCGGTGCTCA -> CCGGTGCTCAA
GCCGTGAAACT -> CCGTGAAACTG
GCCGTTGTCTG -> CCGTTGTCTGA
GCCTAAGTCCC -> CCTAAGTCCCG
GCCTAGGGAGT -> CCTAGGGAGTG
GCCTCACGTAA -> CCTCACGTAAA
GCCTCAGCACC -> CCTCAGCACCG
GCCTCCACATG -> CCTCCACATGT
GCCTCGGATCC -> CCTCGGATCCG
GCCTCTATGCG -> CCTCTATGCGC
GCCTTGGAGAA -> CCTTGGAGAAT
GCCTTTACCAA -> CCTTTACCAAG
GCGAAATTGAG -> CGAAATTGAGC
GCGAAGCCGAT -> CGAAGCCGATG
GCGAGAACGGG -> CGAGAACGGGT
GCGCATTCCGA -> CGCATTCCGAG
GCGCCATAGTA -> CGCCATAGTAC
GCGCCGACCGA -> CGCCGACCGAT
GCGCGAGAACG -> CGCGAGAACGG
GCGCGGGTCGT -> CGCGGGTCGTG
GCGCTACGTAG -> CGCTACGTAGC
GCGGCCAGTAC -> CGGCCAGTACC
GCGGCGGCTTG -> CGGCGGCTTGT
GCGGCTTGTAA -> CGGCTTGTAAG
GCGGGAGGGAA -> CGGGAGGGAAA
GCGGGCTGCCA -> CGGGCTGCCAT
GCGGGTCGTGG -> CGGGTCGTGGC
GCGGTTTGCGT -> CGGTTTGCGTT
GCGTACGTGTC -> CGTACGTGTCT
GCGTCCAAGAG -> CGTCCAAGAGC
GCGTGATTGTC -> CGTGATTGTCA
GCGTGTGAGGT -> CGTGTGAGGTG
GCGTTCTAAAT -> CGTTCTAAATA
GCGTTTACAGT -> CGTTTACAGTT
GCGTTTACATA -> CGTTTACATAA
GCTACGGTTCG -> CTACGGTTCGA
GCTACGTAGCA -> CTACGTAGCAT
GCTATAGTCAT -> CTATAGTCATT
GCTATGCTTCG -> CTATGCTTCGC
GCTATTAAGTT -> CTATTAAGTTT
GCTATTCGTCG -> CTATTCGTCGA
GCTCAAATGTT -> CTCAAATGTTT
GCTCGACCGCC -> CTCGACCGCCC
GCTCGTTACAA -> CTCGTTACAAG
GCTGCAATAAG -> CTGCAATAAGC
GCTGCCATACC -> CTGCCATACCT
GCTGCTCGTTA -> CTGCTCGTTAC
GCTGGCCAACA -> CTGGCCAACAG
GCTGGCCATGA -> CTGGCCATGAT
GCTGGCGTTTA -> CTGGCGTTTAC
GCTGGGGTTAG -> CTGGGGTTAGT
GCTGGTACATT -> CTGGTACATTC
GCTTACATGAG -> CTTACATGAGC
GCTTCGCATCT -> CTTCGCATCTC
GCTTCGGGGCG -> CTTCGGGGCGT
GCTTGCAGTAA -> CTTGCAGTAAA
GCTTGTAAGTC -> CTTGTAAGTCT
GCTTTACAAGA -> CTTTACAAGAG
GCTTTCAGGGT -> CTTTCAGGGTC
GCTTTCGGATC -> CTTTCGGATCG
GGAAAAATTAG -> GAAAAATTAGC
GGAAACAGCCA -> GAAACAGCCAT
GGAAACATTGG -> GAAACATTGGT
GGAAACTCTCA -> GAAACTCTCAT
GGAACAGCGTG -> GAACAGCGTGA
GGAACTTACTG -> GAACTTACTGG
GGAAGCTGGGG -> GAAGCTGGGGT
GGAAGTACCTC -> GAAGTACCTCG
GGAATCTAATA -> GAATCTAATAC
GGAATTGCCAT -> GAATTGCCATT
GGACACTTCAC -> GACACTTCACA
GGACATAAGCA -> GACATAAGCAT
GGACGACCTCG -> GACGACCTCGC
GGACGCTACGG -> GACGCTACGGT
GGACGCTATAG -> GACGCTATAGT
GGACTGCCAAC -> GACTGCCAACG
GGAGAATCGGG -> GAGAATCGGGG
GGAGATACGTC -> GAGATACGTCC
GGAGCGGGCTG -> GAGCGGGCTGC
GGAGGATGACC -> GAGGATGACCA
GGAGGCCGAAG -> GAGGCCGAAGC
GGAGGGAAACA -> GAGGGAAACAT
GGAGTGTCCTT -> GAGTGTCCTTC
GGATATGTTAA -> GATATGTTAAC
GGATCACGCAT -> GATCACGCATG
GGATCCGCAGG -> GATCCGCAGGG
GGATCCGGGAG -> GATCCGGGAGC
GGATCGATATG -> GATCGATATGC
GGATCGGCTGC -> GATCGGCTGCT
GGATGACCATG -> GATGACCATGC
GGATGGTGTGC -> GATGGTGTGCT
GGATTCGAATC -> GATTCGAATCT
GGCAGGATGGT -> GCAGGATGGTG
GGCAGTCACCT -> GCAGTCACCTA
GGCATATGCCT -> GCATATGCCTT
GGCATGACGGT -> GCATGACGGTT
GGCCAAAACGT -> GCCAAAACGTT
GGCCAACAGAA -> GCCAACAGAAT
GGCCAGTACCA -> GCCAGTACCAT
GGCCATGATCC -> GCCATGATCCT
GGCCCCCATAC -> GCCCCCATACC
GGCCGAAGCAA -> GCCGAAGCAAT
GGCCGCCAAGC -> GCCGCCAAGCT
GGCCGGTGCTC -> GCCGGTGCTCA
GGCCTCGGATC -> GCCTCGGATCC
GGCCTTGGAGA -> GCCTTGGAGAA
GGCGCATTCCG -> GCGCATTCCGA
GGCGCCGACCG -> GCGCCGACCGA
GGCGGCTTGTA -> GCGGCTTGTAA
GGCGGGAGGGA -> GCGGGAGGGAA
GGCGTCCAAGA -> GCGTCCAAGAG
GGCGTTTACAT -> GCGTTTACATA
GGCTGCCATAC -> GCTGCCATACC
GGCTGCTCGTT -> GCTGCTCGTTA
GGCTTACATGA -> GCTTACATGAG
GGCTTCGGGGC -> GCTTCGGGGCG
GGCTTGTAAGT -> GCTTGTAAGTC
GGGAAACAGCC -> GGAAACAGCCA
GGGAAACATTG -> GGAAACATTGG
GGGAACTTACT -> GGAACTTACTG
GGGAATCTAAT -> GGAATCTAATA
GGGACATAAGC -> GGACATAAGCA
GGGAGCGGGCT -> GGAGCGGGCTG
GGGAGGGAAAC -> GGAGGGAAACA
GGGAGTGTCCT -> GGAGTGTCCTT
GGGATCACGCA -> GGATCACGCAT
GGGCCGCCAAG -> GGCCGCCAAGC
GGGCGTCCAAG -> GGCGTCCAAGA
GGGCTGCCATA -> GGCTGCCATAC
GGGCTTACATG -> GGCTTACATGA
GGGGAAACAGC -> GGGAAACAGCC
GGGGAACTTAC -> GGGAACTTACT
GGGGCCGCCAA -> GGGCCGCCAAG
GGGGCGTCCAA -> GGGCGTCCAAG
GGGGGTATCGA -> GGGGTATCGAA
GGGGGTGCTGG -> GGGGTGCTGGC
GGGGTACGCCT -> GGGTACGCCTC
GGGGTATCGAA -> GGGTATCGAAT
GGGGTGCTGGC -> GGGTGCTGGCC
GGGGTTAGTGT -> GGGTTAGTGTA
GGGTAAGGGTC -> GGTAAGGGTCA
GGGTACAAAGC -> GGTACAAAGCC
GGGTACGCCTC -> GGTACGCCTCC
GGGTAGGAACA -> GGTAGGAACAG
GGGTATCGAAT -> GGTATCGAATC
GGGTCACCTCC -> GGTCACCTCCT
GGGTCGTGGCA -> GGTCGTGGCAG
GGGTCTAATTC -> GGTCTAATTCG
GGGTCTCGTTA -> GGTCTCGTTAC
GGGTGCTGGCC -> GGTGCTGGCCA
GGGTTAGTGTA -> GGTTAGTGTAA
GGGTTGCAATA -> GGTTGCAATAA
GGTAAAAGGGA -> GTAAAAGGGAC
GGTAAGGGTCA -> GTAAGGGTCAC
GGTACAAAGCC -> GTACAAAGCCA
GGTACATTCCG -> GTACATTCCGA
GGTACCGGGGA -> GTACCGGGGAA
GGTACGCCTCC -> GTACGCCTCCA
GGTAGGAACAG -> GTAGGAACAGC
GGTAGGACGCT -> GTAGGACGCTA
GGTATCGAATC -> GTATCGAATCA
GGTATGCTATT -> GTATGCTATTA
GGTATGGCCAA -> GTATGGCCAAA
GGTCAAAAAAC -> GTCAAAAAACA
GGTCAAGTGGT -> GTCAAGTGGTC
GGTCACCTCCT -> GTCACCTCCTT
GGTCCACGGTG -> GTCCACGGTGA
GGTCCCAGAAT -> GTCCCAGAATG
GGTCCCGAGCT -> GTCCCGAGCTG
GGTCCGAACTC -> GTCCGAACTCA
GGTCCGCCTAA -> GTCCGCCTAAG
GGTCCTTTTCC -> GTCCTTTTCCG
GGTCGTGGCAG -> GTCGTGGCAGT
GGTCTAATTCG -> GTCTAATTCGT
GGTCTCGTTAC -> GTCTCGTTACG
GGTCTGGACTG -> GTCTGGACTGC
GGTGAAGCCGT -> GTGAAGCCGTG
GGTGCTCAAAT -> GTGCTCAAATG
GGTGCTGGCCA -> GTGCTGGCCAT
GGTGCTTTACA -> GTGCTTTACAA
GGTGGAGATAC -> GTGGAGATACG
GGTGGCGCCGA -> GTGGCGCCGAC
GGTGGTAAAAG -> GTGGTAAAAGG
GGTGGTACCGG -> GTGGTACCGGG
GGTGTGCTGCA -> GTGTGCTGCAA
GGTTAGTGTAA -> GTTAGTGTAAG
GGTTCGAGACA -> GTTCGAGACAC
GGTTCGGGATC -> GTTCGGGATCA
GGTTGAGAGGA -> GTTGAGAGGAG
GGTTGATATTC -> GTTGATATTCA
GGTTGCAATAA -> GTTGCAATAAC
GGTTTCCACAT -> GTTTCCACATA
GGTTTGCGTTC -> GTTTGCGTTCT
GTAAAACCATA -> TAAAACCATAA
GTAAAAGGGAC -> TAAAAGGGACA
GTAAAATCGAT -> TAAAATCGATG
GTAAATACCGG -> TAAATACCGGA
GTAAGCTGGTA -> TAAGCTGGTAC
GTAAGGGTCAC -> TAAGGGTCACC
GTAAGTCTGGC -> TAAGTCTGGCA
GTAAGTGTTCG -> TAAGTGTTCGT
GTAATCAATAA -> TAATCAATAAG
GTACAAAGCCA -> TACAAAGCCAC
GTACACAACCG -> TACACAACCGA
GTACAGAATAC -> TACAGAATACT
GTACATTCCGA -> TACATTCCGAT
GTACATTCTTC -> TACATTCTTCG
GTACCATCTAC -> TACCATCTACA
GTACCGGGGAA -> TACCGGGGAAC
GTACCTCGAGA -> TACCTCGAGAC
GTACGCCTCCA -> TACGCCTCCAC
GTACGTGTCTG -> TACGTGTCTGT
GTAGCATGCCC -> TAGCATGCCCA
GTAGGAACAGC -> TAGGAACAGCG
GTAGGACGCTA -> TAGGACGCTAT
GTAGGCCTTGG -> TAGGCCTTGGA
GTATACACGCC -> TATACACGCCT
GTATCGAATCA -> TATCGAATCAA
GTATGCTATTA -> TATGCTATTAA
GTATGGCCAAA -> TATGGCCAAAA
GTATTCAATAC -> TATTCAATACG
GTCAAAAAACA -> TCAAAAAACAT
GTCAAACGACG -> TCAAACGACGA
GTCAACAGAAG -> TCAACAGAAGG
GTCAAGTGGTC -> TCAAGTGGTCC
GTCAATTCGGT -> TCAATTCGGTG
GTCACATCACT -> TCACATCACTA
GTCACCTATGA -> TCACCTATGAA
GTCACCTCCTT -> TCACCTCCTTT
GTCAGATGTCA -> TCAGATGTCAG
GTCAGCATGAT -> TCAGCATGATT
GTCAGCCATTA -> TCAGCCATTAT
GTCAGTGCCGA -> TCAGTGCCGAC
GTCATTTGGGG -> TCATTTGGGGT
GTCCAAGAGCA -> TCCAAGAGCAG
GTCCACGGTGA -> TCCACGGTGAA
GTCCAGGCCCC -> TCCAGGCCCCC
GTCCCACCTCA -> TCCCACCTCAG
GTCCCAGAATG -> TCCCAGAATGG
GTCCCAGGGTA -> TCCCAGGGTAA
GTCCCGAGCTG -> TCCCGAGCTGG
GTCCCGTTGTC -> TCCCGTTGTCA
GTCCGAACTCA -> TCCGAACTCAA
GTCCGCCTAAG -> TCCGCCTAAGT
GTCCGCTATTC -> TCCGCTATTCG
GTCCTTCATGT -> TCCTTCATGTA
GTCCTTTTCCG -> TCCTTTTCCGA
GTCGATCCGCG -> TCGATCCGCGT
GTCGTCAGCCA -> TCGTCAGCCAT
GTCGTGGCAGT -> TCGTGGCAGTC
GTCTAAGGTCT -> TCTAAGGTCTG
GTCTAATCCCC -> TCTAATCCCCA
GTCTAATTCGT -> TCTAATTCGTT
GTCTCGTTACG -> TCTCGTTACGA
GTCTGAAGACC -> TCTGAAGACCG
GTCTGGACTGC -> TCTGGACTGCC
GTCTGGCATAT -> TCTGGCATATG
GTCTGGTCCCG -> TCTGGTCCCGA
GTCTGTGAACT -> TCTGTGAACTA
GTCTTGCGCCA -> TCTTGCGCCAT
GTCTTGCTTTC -> TCTTGCTTTCA
GTGAAACTGGT -> TGAAACTGGTG
GTGAACTAGCA -> TGAACTAGCAA
GTGAAGCCGTG -> TGAAGCCGTGA
GTGAGGTGGCG -> TGAGGTGGCGC
GTGATCGTGTG -> TGATCGTGTGT
GTGATTGTCAA -> TGATTGTCAAT
GTGCATATCCA -> TGCATATCCAT
GTGCCGACCAG -> TGCCGACCAGT
GTGCTCAAATG -> TGCTCAAATGT
GTGCTGCAATA -> TGCTGCAATAA
GTGCTGGCCAT -> TGCTGGCCATG
GTGCTTTACAA -> TGCTTTACAAG
GTGGAGATACG -> TGGAGATACGT
GTGGATTCGAA -> TGGATTCGAAT
GTGGCAGTCAC -> TGGCAGTCACC
GTGGCGCCGAC -> TGGCGCCGACC
GTGGTAAAAGG -> TGGTAAAAGGG
GTGGTACCGGG -> TGGTACCGGGG
GTGGTCCGAAC -> TGGTCCGAACT
GTGGTCCGCCT -> TGGTCCGCCTA
GTGGTGCTTTA -> TGGTGCTTTAC
GTGTAAGTGTT -> TGTAAGTGTTC
GTGTCCTTCAT -> TGTCCTTCATG
GTGTCTGTGAA -> TGTCTGTGAAC
GTGTGAGGTGG -> TGTGAGGTGGC
GTGTGCTGCAA -> TGTGCTGCAAT
GTGTGTGTTAT -> TGTGTGTTATT
GTGTGTTATTC -> TGTGTTATTCC
GTGTTATTCCA -> TGTTATTCCAA
GTGTTCGTATA -> TGTTCGTATAC
GTGTTCTCAGG -> TGTTCTCAGGG
GTTAAAATTAG -> TTAAAATTAGA
GTTAACTTCTA -> TTAACTTCTAT
GTTAAGGTCAA -> TTAAGGTCAAA
GTTACAAGACT -> TTACAAGACTC
GTTACGATCTG -> TTACGATCTGA
GTTAGTGTAAG -> TTAGTGTAAGT
GTTATTCCAAT -> TTATTCCAATC
GTTCCGCCTAG -> TTCCGCCTAGG
GTTCCGTTCGG -> TTCCGTTCGGC
GTTCGAGACAC -> TTCGAGACACT
GTTCGAGGTTG -> TTCGAGGTTGA
GTTCGGCATGA -> TTCGGCATGAC
GTTCGGCCGGT -> TTCGGCCGGTG
GTTCGGGATCA -> TTCGGGATCAC
GTTCGTATACA -> TTCGTATACAC
GTTCGTGGATT -> TTCGTGGATTC
GTTCGTGGTGC -> TTCGTGGTGCT
GTTCTAAATAG -> TTCTAAATAGG
GTTCTCAGGGC -> TTCTCAGGGCT
GTTGAGAGGAG -> TTGAGAGGAGG
GTTGATATTCA -> TTGATATTCAC
GTTGCAATAAC -> TTGCAATAACT
GTTGTCAGATG -> TTGTCAGATGT
GTTGTCAGTGC -> TTGTCAGTGCC
GTTGTCTGAAG -> TTGTCTGAAGA
GTTTACAGTTG -> TTTACAGTTGT
GTTTACATAAC -> TTTACATAACA
GTTTACGCTTG -> TTTACGCTTGC
GTTTATTGAGG -> TTTATTGAGGA
GTTTCCACATA -> TTTCCACATAT
GTTTGCGTTCT -> TTTGCGTTCTA
GTTTGCGTTTA -> TTTGCGTTTAC
GTTTGGAAACT -> TTTGGAAACTC
GTTTTATGGAC -> TTTTATGGACA
GTTTTATGTCC -> TTTTATGTCCG
TAAAACCATAA -> AAAACCATAAC
TAAAAGGGACA -> AAAAGGGACAT
TAAAATCGATG -> AAAATCGATGT
TAAAATTAGAA -> AAAATTAGAAG
TAAATACCGGA -> AAATACCGGAA
TAAATAGGGGC -> AAATAGGGGCC
TAACAATCTCT -> AACAATCTCTG
TAACTATGGTT -> AACTATGGTTT
TAACTTAGCTT -> AACTTAGCTTT
TAACTTCTATG -> AACTTCTATGG
TAAGAAGAAGC -> AAGAAGAAGCA
TAAGATAATGT -> AAGATAATGTT
TAAGCATAGAG -> AAGCATAGAGC
TAAGCGGCCAG -> AAGCGGCCAGT
TAAGCTGGTAC -> AAGCTGGTACA
TAAGGAAGTAC -> AAGGAAGTACC
TAAGGGGAAAC -> AAGGGGAAACA
TAAGGGTCACC -> AAGGGTCACCT
TAAGGTCAAAA -> AAGGTCAAAAA
TAAGGTCTGGA -> AAGGTCTGGAC
TAAGTCCCGTT -> AAGTCCCGTTG
TAAGTCTGGCA -> AAGTCTGGCAT
TAAGTGTTCGT -> AAGTGTTCGTA
TAAGTTTTATG -> AAGTTTTATGT
TAATACCAGAA -> AATACCAGAAA
TAATCAATAAG -> AATCAATAAGA
TAATCCCCAAC -> AATCCCCAACT
TAATGTTTGGA -> AATGTTTGGAA
TAATTCGTTCG -> AATTCGTTCGT
TACAAAGCCAC -> ACAAAGCCACG
TACAAGACTCT -> ACAAGACTCTC
TACAAGAGTCT -> ACAAGAGTCTA
TACACAACCGA -> ACACAACCGAA
TACACGCCTCA -> ACACGCCTCAC
TACACTGATGA -> ACACTGATGAT
TACAGAATACT -> ACAGAATACTG
TACAGGATATG -> ACAGGATATGT
TACAGTTGTCA -> ACAGTTGTCAG
TACATAACAAT -> ACATAACAATC
TACATATAAGC -> ACATATAAGCA
TACATGAGCAT -> ACATGAGCATG
TACATTCCGAT -> ACATTCCGATG
TACATTCTTCG -> ACATTCTTCGG
TACCAAGATTG -> ACCAAGATTGA
TACCAGAAAAA -> ACCAGAAAAAA
TACCATCTACA -> ACCATCTACAC
TACCCCAACGT -> ACCCCAACGTC
TACCCCAGGTC -> ACCCCAGGTCA
TACCGCGGCGG -> ACCGCGGCGGC
TACCGGAAAAA -> ACCGGAAAAAT
TACCGGGGAAC -> ACCGGGGAACT
TACCTCGAGAC -> ACCTCGAGACT
TACCTGAATAT -> ACCTGAATATT
TACGATCTGAT -> ACGATCTGATG
TACGCCTCCAC -> ACGCCTCCACA
TACGCGAAATT -> ACGCGAAATTG
TACGCTTGCAG -> ACGCTTGCAGT
TACGGCAGGAT -> ACGGCAGGATG
TACGGTTCGAG -> ACGGTTCGAGA
TACGTAGCATG -> ACGTAGCATGC
TACGTCCAGGC -> ACGTCCAGGCC
TACGTGTCTGT -> ACGTGTCTGTG
TACTGGCTTCG -> ACTGGCTTCGG
TACTGTACACA -> ACTGTACACAA
TAGAAGCACGG -> AGAAGCACGGT
TAGACTATGCC -> AGACTATGCCT
TAGAGCGCGGG -> AGAGCGCGGGT
TAGCAAAGTAC -> AGCAAAGTACA
TAGCATGCCCA -> AGCATGCCCAC
TAGCCCCGTTT -> AGCCCCGTTTA
TAGCGAAGCCG -> AGCGAAGCCGA
TAGCTTTCGGA -> AGCTTTCGGAT
TAGGAACAGCG -> AGGAACAGCGT
TAGGACGCTAT -> AGGACGCTATA
TAGGAGGCCGA -> AGGAGGCCGAA
TAGGCCTTGGA -> AGGCCTTGGAG
TAGGGAGTGTC -> AGGGAGTGTCC
TAGGGGCCGCC -> AGGGGCCGCCA
TAGGTGGAGAT -> AGGTGGAGATA
TAGTAAGCTGG -> AGTAAGCTGGT
TAGTACAGAAT -> AGTACAGAATA
TAGTCATTTGG -> AGTCATTTGGG
TAGTCCCACCT -> AGTCCCACCTC
TAGTGTAAGTG -> AGTGTAAGTGT
TATAAGCACTA -> ATAAGCACTAT
TATACACGCCT -> ATACACGCCTC
TATAGACTATG -> ATAGACTATGC
TATAGTAAGCT -> ATAGTAAGCTG
TATAGTCATTT -> ATAGTCATTTG
TATCAATTTGG -> ATCAATTTGGG
TATCACCCCGG -> ATCACCCCGGG
TATCCATGGAC -> ATCCATGGACG
TATCGAATCAA -> ATCGAATCAAT
TATCTCCTTGT -> ATCTCCTTGTA
TATCTGTCTTG -> ATCTGTCTTGC
TATGAAACGGG -> ATGAAACGGGT
TATGCCCGCCA -> ATGCCCGCCAA
TATGCCTCTAT -> ATGCCTCTATG
TATGCCTTTAC -> ATGCCTTTACC
TATGCGCGAGA -> ATGCGCGAGAA
TATGCGCTACG -> ATGCGCTACGT
TATGCTATTAA -> ATGCTATTAAG
TATGCTTCGCA -> ATGCTTCGCAT
TATGGACACTT -> ATGGACACTTC
TATGGCCAAAA -> ATGGCCAAAAC
TATGGCCTCGG -> ATGGCCTCGGA
TATGGTATGGC -> ATGGTATGGCC
TATGGTTTCCA -> ATGGTTTCCAC
TATGTCCGCTA -> ATGTCCGCTAT
TATGTTAACTT -> ATGTTAACTTC
TATTAAGTTTT -> ATTAAGTTTTA
TATTATAGTAA -> ATTATAGTAAG
TATTCAATACG -> ATTCAATACGC
TATTCACCCTA -> ATTCACCCTAG
TATTCATTAAG -> ATTCATTAAGG
TATTCCAATCG -> ATTCCAATCGT
TATTCGTCGAT -> ATTCGTCGATC
TATTGAGGAAT -> ATTGAGGAATT
TCAAAAAACAT -> CAAAAAACATA
TCAAACGACGA -> CAAACGACGAT
TCAAACTTGAC -> CAAACTTGACT
TCAAAGACAGA -> CAAAGACAGAG
TCAAATGTTTA -> CAAATGTTTAC
TCAACAGAAGG -> CAACAGAAGGT
TCAAGTGGTCC -> CAAGTGGTCCG
TCAATAAGATA -> CAATAAGATAA
TCAATACGCGA -> CAATACGCGAA
TCAATCAAACT -> CAATCAAACTT
TCAATGAGAGT -> CAATGAGAGTG
TCAATTCGGTG -> CAATTCGGTGG
TCAATTTGGGA -> CAATTTGGGAA
TCACAGGACGA -> CACAGGACGAC
TCACATCACTA -> CACATCACTAT
TCACCCCGGGT -> CACCCCGGGTA
TCACCCTAGGT -> CACCCTAGGTG
TCACCTATGAA -> CACCTATGAAA
TCACCTCCTTT -> CACCTCCTTTC
TCACGCATGTG -> CACGCATGTGA
TCACGTAAAAT -> CACGTAAAATC
TCACGTCTTGC -> CACGTCTTGCT
TCACTATCTCC -> CACTATCTCCT
TCAGAAGTTCC -> CAGAAGTTCCG
TCAGACTCAAT -> CAGACTCAATG
TCAGATGTCAG -> CAGATGTCAGC
TCAGCACCGTA -> CAGCACCGTAA
TCAGCATGATT -> CAGCATGATTC
TCAGCCATTAT -> CAGCCATTATC
TCAGGGCTTAC -> CAGGGCTTACA
TCAGGGTCTCG -> CAGGGTCTCGT
TCAGTGCCGAC -> CAGTGCCGACC
TCATGATACCC -> CATGATACCCC
TCATGTAATCA -> CATGTAATCAA
TCATTAAGGGG -> CATTAAGGGGA
TCATTCTAAGG -> CATTCTAAGGA
TCATTTGGGGT -> CATTTGGGGTA
TCCAAATCGAG -> CCAAATCGAGC
TCCAAGAGCAG -> CCAAGAGCAGC
TCCAATCGTGT -> CCAATCGTGTT
TCCACATATAG -> CCACATATAGA
TCCACATGTCT -> CCACATGTCTA
TCCACGGTGAA -> CCACGGTGAAG
TCCAGGCCCCC -> CCAGGCCCCCA
TCCATGGACGC -> CCATGGACGCT
TCCCACCTCAG -> CCCACCTCAGA
TCCCAGAATGG -> CCCAGAATGGC
TCCCAGGGTAA -> CCCAGGGTAAG
TCCCCAACTTT -> CCCCAACTTTT
TCCCGAGCTGG -> CCCGAGCTGGC
TCCCGTTGTCA -> CCCGTTGTCAG
TCCGAACTCAA -> CCGAACTCAAA
TCCGAGCCGTT -> CCGAGCCGTTG
TCCGATGGATC -> CCGATGGATCC
TCCGATTTCCT -> CCGATTTCCTA
TCCGCAGGGGG -> CCGCAGGGGGT
TCCGCCTAAGT -> CCGCCTAAGTC
TCCGCCTAGGG -> CCGCCTAGGGA
TCCGCGTACGT -> CCGCGTACGTG
TCCGCTATTCG -> CCGCTATTCGT
TCCGGGAGCGG -> CCGGGAGCGGG
TCCGTCACATC -> CCGTCACATCA
TCCGTTCGGCA -> CCGTTCGGCAT
TCCGTTCGGCC -> CCGTTCGGCCG
TCCTAGCCCCG -> CCTAGCCCCGT
TCCTTCATGTA -> CCTTCATGTAA
TCCTTGTATTC -> CCTTGTATTCA
TCCTTTCCGTT -> CCTTTCCGTTC
TCCTTTGCCTC -> CCTTTGCCTCA
TCCTTTTCCGA -> CCTTTTCCGAT
TCGAATCAATC -> CGAATCAATCA
TCGAATCTTGG -> CGAATCTTGGA
TCGACCGCCCA -> CGACCGCCCAT
TCGAGACACTG -> CGAGACACTGG
TCGAGACTGTT -> CGAGACTGTTC
TCGAGCTCGAC -> CGAGCTCGACC
TCGAGGTTGAT -> CGAGGTTGATA
TCGATAAGAAG -> CGATAAGAAGA
TCGATATGCGC -> CGATATGCGCT
TCGATCCGCGT -> CGATCCGCGTA
TCGATGTTAAG -> CGATGTTAAGG
TCGCAGTTAAA -> CGCAGTTAAAA
TCGCATCTCGC -> CGCATCTCGCC
TCGCCACTGAT -> CGCCACTGATC
TCGCTGGCGTT -> CGCTGGCGTTT
TCGGAAGCTGG -> CGGAAGCTGGG
TCGGATCCGGG -> CGGATCCGGGA
TCGGATCGGCT -> CGGATCGGCTG
TCGGCATGACG -> CGGCATGACGG
TCGGCCGGTGC -> CGGCCGGTGCT
TCGGCTGCTCG -> CGGCTGCTCGT
TCGGGATCACG -> CGGGATCACGC
TCGGGGCGTCC -> CGGGGCGTCCA
TCGGGGGTGCT -> CGGGGGTGCTG
TCGGTAGGACG -> CGGTAGGACGC
TCGGTGGTACC -> CGGTGGTACCG
TCGTATACACG -> CGTATACACGC
TCGTCAGCCAT -> CGTCAGCCATT
TCGTCGATCCG -> CGTCGATCCGC
TCGTGGATTCG -> CGTGGATTCGA
TCGTGGCAGTC -> CGTGGCAGTCA
TCGTGGTGCTT -> CGTGGTGCTTT
TCGTGTGTGTT -> CGTGTGTGTTA
TCGTGTTCTCA -> CGTGTTCTCAG
TCGTTACAAGA -> CGTTACAAGAC
TCGTTACGATC -> CGTTACGATCT
TCGTTCGTGGT -> CGTTCGTGGTG
TCGTTTGCGTT -> CGTTTGCGTTT
TCTAAATAGGG -> CTAAATAGGGG
TCTAAGGAAGT -> CTAAGGAAGTA
TCTAAGGTCTG -> CTAAGGTCTGG
TCTAATACCAG -> CTAATACCAGA
TCTAATCCCCA -> CTAATCCCCAA
TCTAATTCGTT -> CTAATTCGTTC
TCTACACTGAT -> CTACACTGATG
TCTATGCGCGA -> CTATGCGCGAG
TCTATGGCCTC -> CTATGGCCTCG
TCTCAGGGCTT -> CTCAGGGCTTA
TCTCATGATAC -> CTCATGATACC
TCTCCGTCACA -> CTCCGTCACAT
TCTCCTTGTAT -> CTCCTTGTATT
TCTCGCCACTG -> CTCGCCACTGA
TCTCGTTACGA -> CTCGTTACGAT
TCTCGTTTGCG -> CTCGTTTGCGT
TCTCTGTTCCG -> CTCTGTTCCGT
TCTGAAGACCG -> CTGAAGACCGA
TCTGATGAACC -> CTGATGAACCG
TCTGGACTGCC -> CTGGACTGCCA
TCTGGCATATG -> CTGGCATATGC
TCTGGTCCCGA -> CTGGTCCCGAG
TCTGTCTTGCG -> CTGTCTTGCGC
TCTGTGAACTA -> CTGTGAACTAG
TCTGTTCCGTT -> CTGTTCCGTTC
TCTTACGGCAG -> CTTACGGCAGG
TCTTCGGTAGG -> CTTCGGTAGGA
TCTTGCGCCAT -> CTTGCGCCATA
TCTTGCTTTCA -> CTTGCTTTCAG
TCTTGGATCGA -> CTTGGATCGAT
TGAAACGGGTA -> GAAACGGGTAC
TGAAACTGGTG -> GAAACTGGTGG
TGAACCGGTCC -> GAACCGGTCCT
TGAACTAGCAA -> GAACTAGCAAA
TGAAGACCGAC -> GAAGACCGACG
TGAAGCCGTGA -> GAAGCCGTGAA
TGAAGCGGTTT -> GAAGCGGTTTG
TGAAGTAGGCC -> GAAGTAGGCCT
TGAATATTCAT -> GAATATTCATT
TGACCATGCGT -> GACCATGCGTG
TGACGGTTCGG -> GACGGTTCGGG
TGACTGAAGCG -> GACTGAAGCGG
TGAGAGGAGGA -> GAGAGGAGGAT
TGAGAGTGCAT -> GAGAGTGCATA
TGAGCATGTCG -> GAGCATGTCGT
TGAGCATTCAC -> GAGCATTCACG
TGAGGAATTGC -> GAGGAATTGCC
TGAGGTGGCGC -> GAGGTGGCGCC
TGATACCCCAG -> GATACCCCAGG
TGATATTCACC -> GATATTCACCC
TGATCATTCTA -> GATCATTCTAA
TGATCCTTTGC -> GATCCTTTGCC
TGATCGCAGTT -> GATCGCAGTTA
TGATCGTGTGT -> GATCGTGTGTG
TGATGAACCGG -> GATGAACCGGT
TGATGATCATT -> GATGATCATTC
TGATTCAGACT -> GATTCAGACTC
TGATTGTCAAT -> GATTGTCAATT
TGCAATAACTT -> GCAATAACTTA
TGCAATAAGCG -> GCAATAAGCGG
TGCAGTAAAAC -> GCAGTAAAACC
TGCATATCCAT -> GCATATCCATG
TGCCAACGTCC -> GCCAACGTCCC
TGCCATACCTG -> GCCATACCTGA
TGCCATTCTTA -> GCCATTCTTAC
TGCCCACCTTG -> GCCCACCTTGT
TGCCCGCCAAC -> GCCCGCCAACT
TGCCGACCAGT -> GCCGACCAGTC
TGCCTCAGCAC -> GCCTCAGCACC
TGCCTCTATGC -> GCCTCTATGCG
TGCCTTTACCA -> GCCTTTACCAA
TGCGCCATAGT -> GCGCCATAGTA
TGCGCGAGAAC -> GCGCGAGAACG
TGCGCTACGTA -> GCGCTACGTAG
TGCGTGTGAGG -> GCGTGTGAGGT
TGCGTTCTAAA -> GCGTTCTAAAT
TGCGTTTACAG -> GCGTTTACAGT
TGCTATTAAGT -> GCTATTAAGTT
TGCTCAAATGT -> GCTCAAATGTT
TGCTCGTTACA -> GCTCGTTACAA
TGCTGCAATAA -> GCTGCAATAAG
TGCTGGCCATG -> GCTGGCCATGA
TGCTTCGCATC -> GCTTCGCATCT
TGCTTTACAAG -> GCTTTACAAGA
TGCTTTCAGGG -> GCTTTCAGGGT
TGGAAACTCTC -> GGAAACTCTCA
TGGACACTTCA -> GGACACTTCAC
TGGACGCTACG -> GGACGCTACGG
TGGACTGCCAA -> GGACTGCCAAC
TGGAGAATCGG -> GGAGAATCGGG
TGGAGATACGT -> GGAGATACGTC
TGGATCCGCAG -> GGATCCGCAGG
TGGATCGATAT -> GGATCGATATG
TGGATTCGAAT -> GGATTCGAATC
TGGCAGTCACC -> GGCAGTCACCT
TGGCATATGCC -> GGCATATGCCT
TGGCCAAAACG -> GGCCAAAACGT
TGGCCAACAGA -> GGCCAACAGAA
TGGCCATGATC -> GGCCATGATCC
TGGCCTCGGAT -> GGCCTCGGATC
TGGCGCATTCC -> GGCGCATTCCG
TGGCGCCGACC -> GGCGCCGACCG
TGGCGGGAGGG -> GGCGGGAGGGA
TGGCGTTTACA -> GGCGTTTACAT
TGGCTTCGGGG -> GGCTTCGGGGC
TGGGAATCTAA -> GGGAATCTAAT
TGGGGTACGCC -> GGGGTACGCCT
TGGGGTTAGTG -> GGGGTTAGTGT
TGGGTCTAATT -> GGGTCTAATTC
TGGTAAAAGGG -> GGTAAAAGGGA
TGGTACATTCC -> GGTACATTCCG
TGGTACCGGGG -> GGTACCGGGGA
TGGTATGCTAT -> GGTATGCTATT
TGGTATGGCCA -> GGTATGGCCAA
TGGTCCCGAGC -> GGTCCCGAGCT
TGGTCCGAACT -> GGTCCGAACTC
TGGTCCGCCTA -> GGTCCGCCTAA
TGGTGCTTTAC -> GGTGCTTTACA
TGGTGGTAAAA -> GGTGGTAAAAG
TGGTGTGCTGC -> GGTGTGCTGCA
TGGTTGAGAGG -> GGTTGAGAGGA
TGGTTTCCACA -> GGTTTCCACAT
TGTAAGTCTGG -> GTAAGTCTGGC
TGTAAGTGTTC -> GTAAGTGTTCG
TGTAATCAATA -> GTAATCAATAA
TGTACACAACC -> GTACACAACCG
TGTATTCAATA -> GTATTCAATAC
TGTCAACAGAA -> GTCAACAGAAG
TGTCAATTCGG -> GTCAATTCGGT
TGTCAGATGTC -> GTCAGATGTCA
TGTCAGCATGA -> GTCAGCATGAT
TGTCAGTGCCG -> GTCAGTGCCGA
TGTCCGCTATT -> GTCCGCTATTC
TGTCCTTCATG -> GTCCTTCATGT
TGTCGTCAGCC -> GTCGTCAGCCA
TGTCTAAGGTC -> GTCTAAGGTCT
TGTCTGAAGAC -> GTCTGAAGACC
TGTCTGTGAAC -> GTCTGTGAACT
TGTCTTGCGCC -> GTCTTGCGCCA
TGTGAACTAGC -> GTGAACTAGCA
TGTGAGGTGGC -> GTGAGGTGGCG
TGTGATCGTGT -> GTGATCGTGTG
TGTGCTGCAAT -> GTGCTGCAATA
TGTGGTCCGCC -> GTGGTCCGCCT
TGTGTGTTATT -> GTGTGTTATTC
TGTGTTATTCC -> GTGTTATTCCA
TGTTAACTTCT -> GTTAACTTCTA
TGTTAAGGTCA -> GTTAAGGTCAA
TGTTATTCCAA -> GTTATTCCAAT
TGTTCCGTTCG -> GTTCCGTTCGG
TGTTCGTATAC -> GTTCGTATACA
TGTTCGTGGAT -> GTTCGTGGATT
TGTTCTCAGGG -> GTTCTCAGGGC
TGTTTACGCTT -> GTTTACGCTTG
TGTTTGGAAAC -> GTTTGGAAACT
TTAAAATTAGA -> TAAAATTAGAA
TTAACTTCTAT -> TAACTTCTATG
TTAAGGGGAAA -> TAAGGGGAAAC
TTAAGGTCAAA -> TAAGGTCAAAA
TTAAGTTTTAT -> TAAGTTTTATG
TTACAAGACTC -> TACAAGACTCT
TTACAAGAGTC -> TACAAGAGTCT
TTACAGTTGTC -> TACAGTTGTCA
TTACATAACAA -> TACATAACAAT
TTACATGAGCA -> TACATGAGCAT
TTACCAAGATT -> TACCAAGATTG
TTACGATCTGA -> TACGATCTGAT
TTACGCTTGCA -> TACGCTTGCAG
TTACGGCAGGA -> TACGGCAGGAT
TTACTGGCTTC -> TACTGGCTTCG
TTAGAAGCACG -> TAGAAGCACGG
TTAGCGAAGCC -> TAGCGAAGCCG
TTAGCTTTCGG -> TAGCTTTCGGA
TTAGTGTAAGT -> TAGTGTAAGTG
TTATAGTAAGC -> TATAGTAAGCT
TTATCAATTTG -> TATCAATTTGG
TTATCACCCCG -> TATCACCCCGG
TTATCTGTCTT -> TATCTGTCTTG
TTATGGACACT -> TATGGACACTT
TTATGTCCGCT -> TATGTCCGCTA
TTATTATAGTA -> TATTATAGTAA
TTATTCCAATC -> TATTCCAATCG
TTATTGAGGAA -> TATTGAGGAAT
TTCAATACGCG -> TCAATACGCGA
TTCACAGGACG -> TCACAGGACGA
TTCACCCTAGG -> TCACCCTAGGT
TTCACGTCTTG -> TCACGTCTTGC
TTCAGACTCAA -> TCAGACTCAAT
TTCAGGGTCTC -> TCAGGGTCTCG
TTCATGTAATC -> TCATGTAATCA
TTCATTAAGGG -> TCATTAAGGGG
TTCCAATCGTG -> TCCAATCGTGT
TTCCACATATA -> TCCACATATAG
TTCCGAGCCGT -> TCCGAGCCGTT
TTCCGATGGAT -> TCCGATGGATC
TTCCGATTTCC -> TCCGATTTCCT
TTCCGCCTAGG -> TCCGCCTAGGG
TTCCGTTCGGC -> TCCGTTCGGCA,TCCGTTCGGCC
TTCCTAGCCCC -> TCCTAGCCCCG
TTCGAATCTTG -> TCGAATCTTGG
TTCGAGACACT -> TCGAGACACTG
TTCGAGGTTGA -> TCGAGGTTGAT
TTCGCATCTCG -> TCGCATCTCGC
TTCGGAAGCTG -> TCGGAAGCTGG
TTCGGATCGGC -> TCGGATCGGCT
TTCGGCATGAC -> TCGGCATGACG
TTCGGCCGGTG -> TCGGCCGGTGC
TTCGGGATCAC -> TCGGGATCACG
TTCGGGGCGTC -> TCGGGGCGTCC
TTCGGTAGGAC -> TCGGTAGGACG
TTCGGTGGTAC -> TCGGTGGTACC
TTCGTATACAC -> TCGTATACACG
TTCGTCGATCC -> TCGTCGATCCG
TTCGTGGATTC -> TCGTGGATTCG
TTCGTGGTGCT -> TCGTGGTGCTT
TTCGTTCGTGG -> TCGTTCGTGGT
TTCTAAATAGG -> TCTAAATAGGG
TTCTAAGGAAG -> TCTAAGGAAGT
TTCTATGGCCT -> TCTATGGCCTC
TTCTCAGGGCT -> TCTCAGGGCTT
TTCTCGTTTGC -> TCTCGTTTGCG
TTCTTACGGCA -> TCTTACGGCAG
TTCTTCGGTAG -> TCTTCGGTAGG
TTGAAGTAGGC -> TGAAGTAGGCC
TTGACTGAAGC -> TGACTGAAGCG
TTGAGAGGAGG -> TGAGAGGAGGA
TTGAGCATTCA -> TGAGCATTCAC
TTGAGGAATTG -> TGAGGAATTGC
TTGATATTCAC -> TGATATTCACC
TTGCAATAACT -> TGCAATAACTT
TTGCAGTAAAA -> TGCAGTAAAAC
TTGCCATTCTT -> TGCCATTCTTA
TTGCCTCAGCA -> TGCCTCAGCAC
TTGCGCCATAG -> TGCGCCATAGT
TTGCGTTCTAA -> TGCGTTCTAAA
TTGCGTTTACA -> TGCGTTTACAG
TTGCTTTCAGG -> TGCTTTCAGGG
TTGGAAACTCT -> TGGAAACTCTC
TTGGAGAATCG -> TGGAGAATCGG
TTGGATCGATA -> TGGATCGATAT
TTGGCGCATTC -> TGGCGCATTCC
TTGGGAATCTA -> TGGGAATCTAA
TTGGGGTACGC -> TGGGGTACGCC
TTGGTATGCTA -> TGGTATGCTAT
TTGTAAGTCTG -> TGTAAGTCTGG
TTGTATTCAAT -> TGTATTCAATA
TTGTCAATTCG -> TGTCAATTCGG
TTGTCAGATGT -> TGTCAGATGTC
TTGTCAGTGCC -> TGTCAGTGCCG
TTGTCTGAAGA -> TGTCTGAAGAC
TTGTGGTCCGC -> TGTGGTCCGCC
TTTACAAGAGT -> TTACAAGAGTC
TTTACAGTTGT -> TTACAGTTGTC
TTTACATAACA -> TTACATAACAA
TTTACCAAGAT -> TTACCAAGATT
TTTACGCTTGC -> TTACGCTTGCA
TTTATCAATTT -> TTATCAATTTG
TTTATGGACAC -> TTATGGACACT
TTTATGTCCGC -> TTATGTCCGCT
TTTATTGAGGA -> TTATTGAGGAA
TTTCAGGGTCT -> TTCAGGGTCTC
TTTCCACATAT -> TTCCACATATA
TTTCCGATTTC -> TTCCGATTTCC
TTTCCGTTCGG -> TTCCGTTCGGC
TTTCCTAGCCC -> TTCCTAGCCCC
TTTCGGAAGCT -> TTCGGAAGCTG
TTTCGGATCGG -> TTCGGATCGGC
TTTGCCTCAGC -> TTGCCTCAGCA
TTTGCGTTCTA -> TTGCGTTCTAA
TTTGCGTTTAC -> TTGCGTTTACA
TTTGGAAACTC -> TTGGAAACTCT
TTTGGGAATCT -> TTGGGAATCTA
TTTGGGGTACG -> TTGGGGTACGC
TTTTATCAATT -> TTTATCAATTT
TTTTATGGACA -> TTTATGGACAC
TTTTATGTCCG -> TTTATGTCCGC
TTTTCCGATTT -> TTTCCGATTTC
